subset,file_name,width,height,class_name,xmin,ymin,xmax,ymax,xc,yc,w,h,aspect_ratio
train,crazing_1.xml,200,200,crazing,2,2,193,194,97.5,98.0,191,192,0.9947916666666666
train,crazing_10.xml,200,200,crazing,60,20,194,69,127.0,44.5,134,49,2.7346938775510203
train,crazing_10.xml,200,200,crazing,9,84,197,198,103.0,141.0,188,114,1.6491228070175439
train,crazing_100.xml,200,200,crazing,1,10,108,121,54.5,65.5,107,111,0.963963963963964
train,crazing_100.xml,200,200,crazing,35,1,200,83,117.5,42.0,165,82,2.0121951219512195
train,crazing_100.xml,200,200,crazing,120,109,196,198,158.0,153.5,76,89,0.8539325842696629
train,crazing_100.xml,200,200,crazing,8,112,164,190,86.0,151.0,156,78,2.0
train,crazing_101.xml,200,200,crazing,40,12,187,152,113.5,82.0,147,140,1.05
train,crazing_102.xml,200,200,crazing,2,2,144,153,73.0,77.5,142,151,0.9403973509933775
train,crazing_102.xml,200,200,crazing,150,85,199,178,174.5,131.5,49,93,0.5268817204301075
train,crazing_103.xml,200,200,crazing,1,18,130,99,65.5,58.5,129,81,1.5925925925925926
train,crazing_103.xml,200,200,crazing,126,29,198,130,162.0,79.5,72,101,0.7128712871287128
train,crazing_103.xml,200,200,crazing,1,107,86,191,43.5,149.0,85,84,1.0119047619047619
train,crazing_104.xml,200,200,crazing,4,4,110,136,57.0,70.0,106,132,0.803030303030303
train,crazing_104.xml,200,200,crazing,142,10,197,56,169.5,33.0,55,46,1.1956521739130435
train,crazing_104.xml,200,200,crazing,137,42,199,116,168.0,79.0,62,74,0.8378378378378378
train,crazing_104.xml,200,200,patches,78,169,118,200,98.0,184.5,40,31,1.2903225806451613
train,crazing_105.xml,200,200,crazing,4,3,113,134,58.5,68.5,109,131,0.8320610687022901
train,crazing_105.xml,200,200,crazing,133,1,197,149,165.0,75.0,64,148,0.43243243243243246
train,crazing_105.xml,200,200,crazing,59,1,197,45,128.0,23.0,138,44,3.1363636363636362
train,crazing_105.xml,200,200,inclusion,5,91,121,125,63.0,108.0,116,34,3.411764705882353
train,crazing_106.xml,200,200,crazing,1,24,127,101,64.0,62.5,126,77,1.6363636363636365
train,crazing_106.xml,200,200,crazing,16,120,189,156,102.5,138.0,173,36,4.805555555555555
train,crazing_106.xml,200,200,crazing,113,152,177,188,145.0,170.0,64,36,1.7777777777777777
train,crazing_107.xml,200,200,crazing,112,46,199,138,155.5,92.0,87,92,0.9456521739130435
train,crazing_107.xml,200,200,crazing,2,1,105,79,53.5,40.0,103,78,1.3205128205128205
train,crazing_107.xml,200,200,crazing,11,146,127,199,69.0,172.5,116,53,2.188679245283019
train,crazing_108.xml,200,200,crazing,3,21,69,149,36.0,85.0,66,128,0.515625
train,crazing_108.xml,200,200,crazing,90,115,198,193,144.0,154.0,108,78,1.3846153846153846
train,crazing_109.xml,200,200,crazing,77,1,199,42,138.0,21.5,122,41,2.975609756097561
train,crazing_109.xml,200,200,crazing,39,38,198,87,118.5,62.5,159,49,3.2448979591836733
train,crazing_109.xml,200,200,crazing,32,88,145,131,88.5,109.5,113,43,2.627906976744186
train,crazing_11.xml,200,200,crazing,20,68,112,111,66.0,89.5,92,43,2.13953488372093
train,crazing_11.xml,200,200,crazing,85,12,193,70,139.0,41.0,108,58,1.8620689655172413
train,crazing_11.xml,200,200,crazing,62,134,142,184,102.0,159.0,80,50,1.6
train,crazing_110.xml,200,200,crazing,105,18,193,75,149.0,46.5,88,57,1.543859649122807
train,crazing_110.xml,200,200,crazing,1,16,89,79,45.0,47.5,88,63,1.3968253968253967
train,crazing_111.xml,200,200,crazing,37,28,167,109,102.0,68.5,130,81,1.6049382716049383
train,crazing_111.xml,200,200,crazing,119,12,199,126,159.0,69.0,80,114,0.7017543859649122
train,crazing_112.xml,200,200,crazing,14,44,123,106,68.5,75.0,109,62,1.7580645161290323
train,crazing_112.xml,200,200,crazing,3,119,138,182,70.5,150.5,135,63,2.142857142857143
train,crazing_112.xml,200,200,patches,124,34,165,112,144.5,73.0,41,78,0.5256410256410257
train,crazing_113.xml,200,200,crazing,23,134,123,186,73.0,160.0,100,52,1.9230769230769231
train,crazing_113.xml,200,200,crazing,1,48,162,116,81.5,82.0,161,68,2.3676470588235294
train,crazing_114.xml,200,200,crazing,41,139,169,188,105.0,163.5,128,49,2.6122448979591835
train,crazing_114.xml,200,200,crazing,5,52,46,198,25.5,125.0,41,146,0.2808219178082192
train,crazing_114.xml,200,200,crazing,2,16,94,91,48.0,53.5,92,75,1.2266666666666666
train,crazing_115.xml,200,200,crazing,9,25,187,74,98.0,49.5,178,49,3.63265306122449
train,crazing_115.xml,200,200,crazing,24,79,109,135,66.5,107.0,85,56,1.5178571428571428
train,crazing_115.xml,200,200,crazing,97,45,192,141,144.5,93.0,95,96,0.9895833333333334
train,crazing_116.xml,200,200,crazing,121,13,174,69,147.5,41.0,53,56,0.9464285714285714
train,crazing_116.xml,200,200,crazing,19,113,134,186,76.5,149.5,115,73,1.5753424657534247
train,crazing_117.xml,200,200,crazing,12,39,154,144,83.0,91.5,142,105,1.3523809523809525
train,crazing_117.xml,200,200,crazing,66,138,169,189,117.5,163.5,103,51,2.019607843137255
train,crazing_118.xml,200,200,crazing,7,144,79,188,43.0,166.0,72,44,1.6363636363636365
train,crazing_118.xml,200,200,crazing,1,65,75,138,38.0,101.5,74,73,1.0136986301369864
train,crazing_118.xml,200,200,crazing,44,120,178,173,111.0,146.5,134,53,2.5283018867924527
train,crazing_118.xml,200,200,crazing,58,82,195,133,126.5,107.5,137,51,2.6862745098039214
train,crazing_119.xml,200,200,crazing,72,63,193,147,132.5,105.0,121,84,1.4404761904761905
train,crazing_119.xml,200,200,crazing,1,112,136,157,68.5,134.5,135,45,3.0
train,crazing_119.xml,200,200,crazing,64,14,171,58,117.5,36.0,107,44,2.4318181818181817
train,crazing_119.xml,200,200,crazing,5,18,137,98,71.0,58.0,132,80,1.65
train,crazing_12.xml,200,200,crazing,1,1,141,50,71.0,25.5,140,49,2.857142857142857
train,crazing_12.xml,200,200,crazing,1,107,119,162,60.0,134.5,118,55,2.1454545454545455
train,crazing_120.xml,200,200,crazing,83,6,178,57,130.5,31.5,95,51,1.8627450980392157
train,crazing_120.xml,200,200,crazing,106,68,200,108,153.0,88.0,94,40,2.35
train,crazing_120.xml,200,200,crazing,1,81,117,146,59.0,113.5,116,65,1.7846153846153847
train,crazing_120.xml,200,200,crazing,1,81,117,146,59.0,113.5,116,65,1.7846153846153847
train,crazing_120.xml,200,200,crazing,91,110,199,152,145.0,131.0,108,42,2.5714285714285716
train,crazing_121.xml,200,200,crazing,72,114,173,171,122.5,142.5,101,57,1.7719298245614035
train,crazing_121.xml,200,200,crazing,23,21,156,72,89.5,46.5,133,51,2.607843137254902
train,crazing_122.xml,200,200,crazing,82,136,195,166,138.5,151.0,113,30,3.7666666666666666
train,crazing_122.xml,200,200,crazing,44,73,109,133,76.5,103.0,65,60,1.0833333333333333
train,crazing_123.xml,200,200,crazing,78,121,194,167,136.0,144.0,116,46,2.5217391304347827
train,crazing_124.xml,200,200,crazing,42,24,185,71,113.5,47.5,143,47,3.0425531914893615
train,crazing_124.xml,200,200,crazing,1,12,39,160,20.0,86.0,38,148,0.25675675675675674
train,crazing_125.xml,200,200,crazing,71,80,193,127,132.0,103.5,122,47,2.595744680851064
train,crazing_125.xml,200,200,crazing,64,23,196,93,130.0,58.0,132,70,1.8857142857142857
train,crazing_125.xml,200,200,crazing,114,66,200,177,157.0,121.5,86,111,0.7747747747747747
train,crazing_126.xml,200,200,crazing,1,63,108,124,54.5,93.5,107,61,1.7540983606557377
train,crazing_126.xml,200,200,crazing,90,23,198,74,144.0,48.5,108,51,2.1176470588235294
train,crazing_127.xml,200,200,crazing,13,132,119,191,66.0,161.5,106,59,1.7966101694915255
train,crazing_127.xml,200,200,crazing,58,24,145,115,101.5,69.5,87,91,0.9560439560439561
train,crazing_128.xml,200,200,crazing,1,34,60,95,30.5,64.5,59,61,0.9672131147540983
train,crazing_128.xml,200,200,crazing,89,79,156,137,122.5,108.0,67,58,1.1551724137931034
train,crazing_128.xml,200,200,crazing,90,28,174,75,132.0,51.5,84,47,1.7872340425531914
train,crazing_129.xml,200,200,crazing,1,76,94,123,47.5,99.5,93,47,1.9787234042553192
train,crazing_129.xml,200,200,crazing,98,58,169,134,133.5,96.0,71,76,0.9342105263157895
train,crazing_13.xml,200,200,crazing,71,21,140,114,105.5,67.5,69,93,0.7419354838709677
train,crazing_13.xml,200,200,crazing,1,126,89,176,45.0,151.0,88,50,1.76
train,crazing_13.xml,200,200,crazing,124,117,199,173,161.5,145.0,75,56,1.3392857142857142
train,crazing_130.xml,200,200,crazing,2,134,155,179,78.5,156.5,153,45,3.4
train,crazing_130.xml,200,200,crazing,2,6,84,99,43.0,52.5,82,93,0.8817204301075269
train,crazing_130.xml,200,200,crazing,77,104,199,158,138.0,131.0,122,54,2.259259259259259
train,crazing_131.xml,200,200,crazing,1,21,153,76,77.0,48.5,152,55,2.7636363636363637
train,crazing_131.xml,200,200,crazing,18,130,122,186,70.0,158.0,104,56,1.8571428571428572
train,crazing_131.xml,200,200,crazing,131,17,194,106,162.5,61.5,63,89,0.7078651685393258
train,crazing_132.xml,200,200,crazing,45,29,148,83,96.5,56.0,103,54,1.9074074074074074
train,crazing_132.xml,200,200,crazing,37,89,152,149,94.5,119.0,115,60,1.9166666666666667
train,crazing_133.xml,200,200,crazing,57,137,162,194,109.5,165.5,105,57,1.8421052631578947
train,crazing_133.xml,200,200,crazing,47,94,169,161,108.0,127.5,122,67,1.8208955223880596
train,crazing_134.xml,200,200,crazing,33,26,133,80,83.0,53.0,100,54,1.8518518518518519
train,crazing_134.xml,200,200,crazing,40,89,141,148,90.5,118.5,101,59,1.7118644067796611
train,crazing_135.xml,200,200,crazing,13,23,158,106,85.5,64.5,145,83,1.7469879518072289
train,crazing_135.xml,200,200,crazing,50,117,178,191,114.0,154.0,128,74,1.7297297297297298
train,crazing_136.xml,200,200,crazing,1,88,88,144,44.5,116.0,87,56,1.5535714285714286
train,crazing_136.xml,200,200,crazing,126,111,191,184,158.5,147.5,65,73,0.8904109589041096
train,crazing_137.xml,200,200,crazing,32,78,164,136,98.0,107.0,132,58,2.2758620689655173
train,crazing_137.xml,200,200,crazing,38,140,95,192,66.5,166.0,57,52,1.0961538461538463
train,crazing_137.xml,200,200,crazing,38,10,88,67,63.0,38.5,50,57,0.8771929824561403
train,crazing_138.xml,200,200,crazing,26,63,141,142,83.5,102.5,115,79,1.4556962025316456
train,crazing_138.xml,200,200,crazing,56,19,115,66,85.5,42.5,59,47,1.2553191489361701
train,crazing_139.xml,200,200,crazing,1,5,99,70,50.0,37.5,98,65,1.5076923076923077
train,crazing_139.xml,200,200,crazing,7,83,97,136,52.0,109.5,90,53,1.6981132075471699
train,crazing_14.xml,200,200,crazing,22,116,108,170,65.0,143.0,86,54,1.5925925925925926
train,crazing_140.xml,200,200,crazing,27,115,145,185,86.0,150.0,118,70,1.6857142857142857
train,crazing_140.xml,200,200,crazing,146,3,194,164,170.0,83.5,48,161,0.2981366459627329
train,crazing_141.xml,200,200,crazing,4,34,58,134,31.0,84.0,54,100,0.54
train,crazing_141.xml,200,200,crazing,73,117,198,157,135.5,137.0,125,40,3.125
train,crazing_142.xml,200,200,crazing,2,143,100,178,51.0,160.5,98,35,2.8
train,crazing_142.xml,200,200,crazing,121,109,185,164,153.0,136.5,64,55,1.1636363636363636
train,crazing_142.xml,200,200,crazing,2,83,84,135,43.0,109.0,82,52,1.5769230769230769
train,crazing_143.xml,200,200,crazing,12,104,95,186,53.5,145.0,83,82,1.0121951219512195
train,crazing_143.xml,200,200,crazing,9,31,137,100,73.0,65.5,128,69,1.855072463768116
train,crazing_144.xml,200,200,crazing,42,24,189,71,115.5,47.5,147,47,3.127659574468085
train,crazing_144.xml,200,200,crazing,50,91,127,157,88.5,124.0,77,66,1.1666666666666667
train,crazing_145.xml,200,200,crazing,20,9,95,83,57.5,46.0,75,74,1.0135135135135136
train,crazing_145.xml,200,200,crazing,27,91,164,176,95.5,133.5,137,85,1.611764705882353
train,crazing_146.xml,200,200,crazing,43,109,95,193,69.0,151.0,52,84,0.6190476190476191
train,crazing_147.xml,200,200,crazing,90,117,164,159,127.0,138.0,74,42,1.7619047619047619
train,crazing_147.xml,200,200,crazing,3,42,72,93,37.5,67.5,69,51,1.3529411764705883
train,crazing_148.xml,200,200,crazing,4,39,85,97,44.5,68.0,81,58,1.396551724137931
train,crazing_149.xml,200,200,crazing,33,5,149,69,91.0,37.0,116,64,1.8125
train,crazing_149.xml,200,200,crazing,26,108,154,179,90.0,143.5,128,71,1.8028169014084507
train,crazing_15.xml,200,200,crazing,27,46,149,101,88.0,73.5,122,55,2.2181818181818183
train,crazing_15.xml,200,200,crazing,27,16,167,65,97.0,40.5,140,49,2.857142857142857
train,crazing_150.xml,200,200,crazing,52,148,186,196,119.0,172.0,134,48,2.7916666666666665
train,crazing_151.xml,200,200,crazing,91,21,134,106,112.5,63.5,43,85,0.5058823529411764
train,crazing_152.xml,200,200,crazing,48,98,146,135,97.0,116.5,98,37,2.6486486486486487
train,crazing_152.xml,200,200,crazing,2,137,135,191,68.5,164.0,133,54,2.462962962962963
train,crazing_152.xml,200,200,patches,156,136,191,168,173.5,152.0,35,32,1.09375
train,crazing_153.xml,200,200,crazing,1,97,65,158,33.0,127.5,64,61,1.0491803278688525
train,crazing_153.xml,200,200,crazing,76,113,147,197,111.5,155.0,71,84,0.8452380952380952
train,crazing_154.xml,200,200,crazing,1,24,90,99,45.5,61.5,89,75,1.1866666666666668
train,crazing_154.xml,200,200,crazing,97,45,172,117,134.5,81.0,75,72,1.0416666666666667
train,crazing_154.xml,200,200,crazing,98,128,182,173,140.0,150.5,84,45,1.8666666666666667
train,crazing_155.xml,200,200,crazing,15,9,107,82,61.0,45.5,92,73,1.2602739726027397
train,crazing_155.xml,200,200,crazing,111,55,191,168,151.0,111.5,80,113,0.7079646017699115
train,crazing_155.xml,200,200,crazing,2,91,108,149,55.0,120.0,106,58,1.8275862068965518
train,crazing_156.xml,200,200,crazing,1,25,92,94,46.5,59.5,91,69,1.318840579710145
train,crazing_156.xml,200,200,crazing,103,24,193,113,148.0,68.5,90,89,1.0112359550561798
train,crazing_156.xml,200,200,crazing,43,98,132,156,87.5,127.0,89,58,1.5344827586206897
train,crazing_157.xml,200,200,crazing,64,3,161,80,112.5,41.5,97,77,1.2597402597402598
train,crazing_157.xml,200,200,crazing,48,87,166,157,107.0,122.0,118,70,1.6857142857142857
train,crazing_158.xml,200,200,crazing,51,57,125,135,88.0,96.0,74,78,0.9487179487179487
train,crazing_159.xml,200,200,crazing,35,4,124,63,79.5,33.5,89,59,1.5084745762711864
train,crazing_159.xml,200,200,crazing,35,118,197,183,116.0,150.5,162,65,2.4923076923076923
train,crazing_16.xml,200,200,crazing,105,124,178,175,141.5,149.5,73,51,1.4313725490196079
train,crazing_16.xml,200,200,crazing,11,102,75,157,43.0,129.5,64,55,1.1636363636363636
train,crazing_160.xml,200,200,crazing,18,20,154,77,86.0,48.5,136,57,2.3859649122807016
train,crazing_160.xml,200,200,crazing,13,108,136,190,74.5,149.0,123,82,1.5
train,crazing_161.xml,200,200,crazing,77,9,152,138,114.5,73.5,75,129,0.5813953488372093
train,crazing_162.xml,200,200,crazing,58,12,130,149,94.0,80.5,72,137,0.5255474452554745
train,crazing_163.xml,200,200,crazing,1,86,69,185,35.0,135.5,68,99,0.6868686868686869
train,crazing_163.xml,200,200,crazing,86,135,191,198,138.5,166.5,105,63,1.6666666666666667
train,crazing_163.xml,200,200,crazing,72,28,189,87,130.5,57.5,117,59,1.9830508474576272
train,crazing_164.xml,200,200,crazing,12,61,91,176,51.5,118.5,79,115,0.6869565217391305
train,crazing_165.xml,200,200,crazing,50,105,138,170,94.0,137.5,88,65,1.353846153846154
train,crazing_165.xml,200,200,crazing,51,1,127,65,89.0,33.0,76,64,1.1875
train,crazing_166.xml,200,200,crazing,35,31,181,105,108.0,68.0,146,74,1.972972972972973
train,crazing_166.xml,200,200,crazing,28,145,157,189,92.5,167.0,129,44,2.9318181818181817
train,crazing_167.xml,200,200,crazing,90,10,179,101,134.5,55.5,89,91,0.978021978021978
train,crazing_167.xml,200,200,crazing,59,133,198,186,128.5,159.5,139,53,2.6226415094339623
train,crazing_168.xml,200,200,crazing,1,47,136,101,68.5,74.0,135,54,2.5
train,crazing_168.xml,200,200,crazing,1,106,129,188,65.0,147.0,128,82,1.5609756097560976
train,crazing_169.xml,200,200,crazing,4,47,147,112,75.5,79.5,143,65,2.2
train,crazing_169.xml,200,200,crazing,27,117,180,152,103.5,134.5,153,35,4.371428571428571
train,crazing_169.xml,200,200,crazing,19,10,139,62,79.0,36.0,120,52,2.3076923076923075
train,crazing_17.xml,200,200,crazing,111,66,188,174,149.5,120.0,77,108,0.7129629629629629
train,crazing_17.xml,200,200,crazing,124,6,195,102,159.5,54.0,71,96,0.7395833333333334
train,crazing_170.xml,200,200,crazing,48,11,135,77,91.5,44.0,87,66,1.3181818181818181
train,crazing_170.xml,200,200,crazing,23,133,104,180,63.5,156.5,81,47,1.7234042553191489
train,crazing_171.xml,200,200,crazing,96,9,192,89,144.0,49.0,96,80,1.2
train,crazing_172.xml,200,200,crazing,4,15,163,87,83.5,51.0,159,72,2.2083333333333335
train,crazing_172.xml,200,200,crazing,61,97,180,176,120.5,136.5,119,79,1.5063291139240507
train,crazing_173.xml,200,200,crazing,62,97,175,153,118.5,125.0,113,56,2.017857142857143
train,crazing_173.xml,200,200,crazing,62,165,198,198,130.0,181.5,136,33,4.121212121212121
train,crazing_173.xml,200,200,crazing,32,27,151,76,91.5,51.5,119,49,2.4285714285714284
train,crazing_174.xml,200,200,crazing,1,82,116,129,58.5,105.5,115,47,2.4468085106382977
train,crazing_174.xml,200,200,crazing,1,134,174,181,87.5,157.5,173,47,3.6808510638297873
train,crazing_175.xml,200,200,crazing,1,141,94,194,47.5,167.5,93,53,1.7547169811320755
train,crazing_175.xml,200,200,crazing,74,92,151,143,112.5,117.5,77,51,1.5098039215686274
train,crazing_176.xml,200,200,crazing,20,50,194,102,107.0,76.0,174,52,3.3461538461538463
train,crazing_176.xml,200,200,crazing,106,109,195,188,150.5,148.5,89,79,1.1265822784810127
train,crazing_177.xml,200,200,crazing,8,140,149,199,78.5,169.5,141,59,2.389830508474576
train,crazing_177.xml,200,200,crazing,101,42,183,110,142.0,76.0,82,68,1.2058823529411764
train,crazing_177.xml,200,200,crazing,6,99,123,161,64.5,130.0,117,62,1.8870967741935485
train,crazing_178.xml,200,200,crazing,3,117,145,184,74.0,150.5,142,67,2.1194029850746268
train,crazing_178.xml,200,200,crazing,13,38,93,114,53.0,76.0,80,76,1.0526315789473684
train,crazing_179.xml,200,200,crazing,1,7,110,79,55.5,43.0,109,72,1.5138888888888888
train,crazing_179.xml,200,200,crazing,1,72,80,151,40.5,111.5,79,79,1.0
train,crazing_18.xml,200,200,crazing,112,89,198,143,155.0,116.0,86,54,1.5925925925925926
train,crazing_18.xml,200,200,crazing,10,100,85,188,47.5,144.0,75,88,0.8522727272727273
train,crazing_180.xml,200,200,crazing,2,96,198,168,100.0,132.0,196,72,2.7222222222222223
train,crazing_180.xml,200,200,crazing,15,51,136,115,75.5,83.0,121,64,1.890625
train,crazing_180.xml,200,200,crazing,115,6,199,116,157.0,61.0,84,110,0.7636363636363637
train,crazing_180.xml,200,200,crazing,27,148,178,200,102.5,174.0,151,52,2.9038461538461537
train,crazing_181.xml,200,200,crazing,25,48,116,112,70.5,80.0,91,64,1.421875
train,crazing_181.xml,200,200,crazing,27,124,103,199,65.0,161.5,76,75,1.0133333333333334
train,crazing_182.xml,200,200,crazing,30,121,80,198,55.0,159.5,50,77,0.6493506493506493
train,crazing_182.xml,200,200,crazing,142,135,183,194,162.5,164.5,41,59,0.6949152542372882
train,crazing_182.xml,200,200,crazing,143,25,188,82,165.5,53.5,45,57,0.7894736842105263
train,crazing_183.xml,200,200,crazing,47,107,190,183,118.5,145.0,143,76,1.881578947368421
train,crazing_183.xml,200,200,crazing,109,66,200,146,154.5,106.0,91,80,1.1375
train,crazing_183.xml,200,200,crazing,7,34,111,124,59.0,79.0,104,90,1.1555555555555554
train,crazing_184.xml,200,200,crazing,2,64,101,127,51.5,95.5,99,63,1.5714285714285714
train,crazing_184.xml,200,200,crazing,58,133,133,191,95.5,162.0,75,58,1.293103448275862
train,crazing_184.xml,200,200,crazing,110,79,199,123,154.5,101.0,89,44,2.022727272727273
train,crazing_185.xml,200,200,crazing,1,81,184,160,92.5,120.5,183,79,2.3164556962025316
train,crazing_186.xml,200,200,crazing,54,91,178,169,116.0,130.0,124,78,1.5897435897435896
train,crazing_186.xml,200,200,crazing,1,4,103,177,52.0,90.5,102,173,0.5895953757225434
train,crazing_186.xml,200,200,crazing,41,15,184,94,112.5,54.5,143,79,1.8101265822784811
train,crazing_187.xml,200,200,crazing,2,27,171,138,86.5,82.5,169,111,1.5225225225225225
train,crazing_188.xml,200,200,crazing,96,75,198,157,147.0,116.0,102,82,1.2439024390243902
train,crazing_188.xml,200,200,crazing,2,3,189,71,95.5,37.0,187,68,2.75
train,crazing_188.xml,200,200,crazing,1,75,124,180,62.5,127.5,123,105,1.1714285714285715
train,crazing_189.xml,200,200,crazing,4,94,177,152,90.5,123.0,173,58,2.9827586206896552
train,crazing_189.xml,200,200,crazing,3,16,133,77,68.0,46.5,130,61,2.1311475409836067
train,crazing_19.xml,200,200,crazing,92,5,135,116,113.5,60.5,43,111,0.38738738738738737
train,crazing_190.xml,200,200,crazing,1,45,127,147,64.0,96.0,126,102,1.2352941176470589
train,crazing_190.xml,200,200,crazing,18,95,182,157,100.0,126.0,164,62,2.6451612903225805
train,crazing_190.xml,200,200,crazing,1,6,147,65,74.0,35.5,146,59,2.4745762711864407
train,crazing_190.xml,200,200,crazing,54,1,177,37,115.5,19.0,123,36,3.4166666666666665
train,crazing_191.xml,200,200,crazing,8,22,169,62,88.5,42.0,161,40,4.025
train,crazing_191.xml,200,200,crazing,26,76,198,133,112.0,104.5,172,57,3.017543859649123
train,crazing_191.xml,200,200,crazing,29,135,106,195,67.5,165.0,77,60,1.2833333333333334
train,crazing_192.xml,200,200,crazing,137,90,198,198,167.5,144.0,61,108,0.5648148148148148
train,crazing_192.xml,200,200,crazing,17,120,129,191,73.0,155.5,112,71,1.5774647887323943
train,crazing_192.xml,200,200,crazing,54,18,199,64,126.5,41.0,145,46,3.152173913043478
train,crazing_193.xml,200,200,crazing,15,34,156,144,85.5,89.0,141,110,1.2818181818181817
train,crazing_194.xml,200,200,crazing,17,58,177,161,97.0,109.5,160,103,1.5533980582524272
train,crazing_195.xml,200,200,crazing,9,89,149,157,79.0,123.0,140,68,2.0588235294117645
train,crazing_196.xml,200,200,crazing,15,42,197,87,106.0,64.5,182,45,4.044444444444444
train,crazing_196.xml,200,200,crazing,68,2,197,46,132.5,24.0,129,44,2.9318181818181817
train,crazing_196.xml,200,200,crazing,3,140,150,199,76.5,169.5,147,59,2.4915254237288136
train,crazing_197.xml,200,200,crazing,15,97,198,181,106.5,139.0,183,84,2.1785714285714284
train,crazing_197.xml,200,200,crazing,12,8,167,91,89.5,49.5,155,83,1.8674698795180722
train,crazing_198.xml,200,200,crazing,47,99,191,189,119.0,144.0,144,90,1.6
train,crazing_198.xml,200,200,crazing,1,48,85,145,43.0,96.5,84,97,0.865979381443299
train,crazing_198.xml,200,200,crazing,71,1,200,42,135.5,21.5,129,41,3.1463414634146343
train,crazing_199.xml,200,200,crazing,7,19,198,88,102.5,53.5,191,69,2.7681159420289854
train,crazing_199.xml,200,200,crazing,1,89,72,159,36.5,124.0,71,70,1.0142857142857142
train,crazing_2.xml,200,200,crazing,99,120,200,174,149.5,147.0,101,54,1.8703703703703705
train,crazing_2.xml,200,200,crazing,8,16,200,111,104.0,63.5,192,95,2.0210526315789474
train,crazing_20.xml,200,200,crazing,1,109,131,193,66.0,151.0,130,84,1.5476190476190477
train,crazing_20.xml,200,200,crazing,86,60,142,100,114.0,80.0,56,40,1.4
train,crazing_20.xml,200,200,patches,140,29,178,65,159.0,47.0,38,36,1.0555555555555556
train,crazing_200.xml,200,200,crazing,42,7,176,84,109.0,45.5,134,77,1.7402597402597402
train,crazing_200.xml,200,200,crazing,7,97,161,146,84.0,121.5,154,49,3.142857142857143
train,crazing_200.xml,200,200,crazing,4,154,92,196,48.0,175.0,88,42,2.0952380952380953
train,crazing_201.xml,200,200,crazing,16,79,143,193,79.5,136.0,127,114,1.1140350877192982
train,crazing_201.xml,200,200,crazing,31,35,160,88,95.5,61.5,129,53,2.4339622641509435
train,crazing_202.xml,200,200,crazing,21,6,174,105,97.5,55.5,153,99,1.5454545454545454
train,crazing_203.xml,200,200,crazing,19,79,148,168,83.5,123.5,129,89,1.449438202247191
train,crazing_203.xml,200,200,crazing,44,10,170,76,107.0,43.0,126,66,1.9090909090909092
train,crazing_204.xml,200,200,crazing,7,132,165,184,86.0,158.0,158,52,3.0384615384615383
train,crazing_205.xml,200,200,crazing,26,144,83,198,54.5,171.0,57,54,1.0555555555555556
train,crazing_206.xml,200,200,crazing,19,53,123,171,71.0,112.0,104,118,0.8813559322033898
train,crazing_206.xml,200,200,crazing,126,29,189,137,157.5,83.0,63,108,0.5833333333333334
train,crazing_207.xml,200,200,crazing,2,43,170,125,86.0,84.0,168,82,2.048780487804878
train,crazing_208.xml,200,200,crazing,1,20,152,76,76.5,48.0,151,56,2.6964285714285716
train,crazing_208.xml,200,200,crazing,1,105,198,194,99.5,149.5,197,89,2.2134831460674156
train,crazing_209.xml,200,200,crazing,11,50,162,175,86.5,112.5,151,125,1.208
train,crazing_209.xml,200,200,crazing,3,3,148,56,75.5,29.5,145,53,2.7358490566037736
train,crazing_21.xml,200,200,crazing,27,27,198,76,112.5,51.5,171,49,3.489795918367347
train,crazing_21.xml,200,200,crazing,20,85,197,120,108.5,102.5,177,35,5.057142857142857
train,crazing_21.xml,200,200,crazing,24,123,198,187,111.0,155.0,174,64,2.71875
train,crazing_210.xml,200,200,crazing,4,41,81,141,42.5,91.0,77,100,0.77
train,crazing_211.xml,200,200,crazing,8,110,160,184,84.0,147.0,152,74,2.054054054054054
train,crazing_211.xml,200,200,crazing,102,1,185,173,143.5,87.0,83,172,0.48255813953488375
train,crazing_211.xml,200,200,crazing,1,31,144,95,72.5,63.0,143,64,2.234375
train,crazing_212.xml,200,200,crazing,1,140,185,199,93.0,169.5,184,59,3.1186440677966103
train,crazing_212.xml,200,200,crazing,10,15,172,109,91.0,62.0,162,94,1.7234042553191489
train,crazing_213.xml,200,200,crazing,26,124,151,198,88.5,161.0,125,74,1.6891891891891893
train,crazing_213.xml,200,200,crazing,33,7,157,56,95.0,31.5,124,49,2.5306122448979593
train,crazing_214.xml,200,200,crazing,9,72,200,149,104.5,110.5,191,77,2.4805194805194803
train,crazing_214.xml,200,200,crazing,31,111,163,192,97.0,151.5,132,81,1.6296296296296295
train,crazing_214.xml,200,200,crazing,48,1,199,61,123.5,31.0,151,60,2.5166666666666666
train,crazing_215.xml,200,200,crazing,1,1,186,54,93.5,27.5,185,53,3.490566037735849
train,crazing_215.xml,200,200,crazing,11,35,197,109,104.0,72.0,186,74,2.5135135135135136
train,crazing_215.xml,200,200,crazing,4,98,184,184,94.0,141.0,180,86,2.0930232558139537
train,crazing_216.xml,200,200,crazing,1,97,53,197,27.0,147.0,52,100,0.52
train,crazing_216.xml,200,200,crazing,23,1,180,93,101.5,47.0,157,92,1.7065217391304348
train,crazing_216.xml,200,200,crazing,55,86,197,190,126.0,138.0,142,104,1.3653846153846154
train,crazing_217.xml,200,200,crazing,25,52,199,92,112.0,72.0,174,40,4.35
train,crazing_217.xml,200,200,crazing,110,99,195,190,152.5,144.5,85,91,0.9340659340659341
train,crazing_218.xml,200,200,crazing,18,58,150,115,84.0,86.5,132,57,2.3157894736842106
train,crazing_218.xml,200,200,crazing,91,16,198,56,144.5,36.0,107,40,2.675
train,crazing_218.xml,200,200,crazing,36,143,175,181,105.5,162.0,139,38,3.6578947368421053
train,crazing_219.xml,200,200,crazing,46,9,116,123,81.0,66.0,70,114,0.6140350877192983
train,crazing_22.xml,200,200,crazing,92,17,198,94,145.0,55.5,106,77,1.3766233766233766
train,crazing_22.xml,200,200,crazing,95,104,200,182,147.5,143.0,105,78,1.3461538461538463
train,crazing_220.xml,200,200,crazing,3,117,146,194,74.5,155.5,143,77,1.8571428571428572
train,crazing_220.xml,200,200,crazing,78,19,178,131,128.0,75.0,100,112,0.8928571428571429
train,crazing_221.xml,200,200,crazing,157,1,200,187,178.5,94.0,43,186,0.23118279569892472
train,crazing_221.xml,200,200,crazing,1,87,136,162,68.5,124.5,135,75,1.8
train,crazing_221.xml,200,200,crazing,79,36,198,90,138.5,63.0,119,54,2.2037037037037037
train,crazing_222.xml,200,200,crazing,1,20,146,103,73.5,61.5,145,83,1.7469879518072289
train,crazing_222.xml,200,200,crazing,155,6,196,133,175.5,69.5,41,127,0.3228346456692913
train,crazing_223.xml,200,200,crazing,113,123,197,197,155.0,160.0,84,74,1.135135135135135
train,crazing_223.xml,200,200,crazing,80,11,173,98,126.5,54.5,93,87,1.0689655172413792
train,crazing_224.xml,200,200,crazing,1,97,122,188,61.5,142.5,121,91,1.3296703296703296
train,crazing_224.xml,200,200,crazing,117,107,199,172,158.0,139.5,82,65,1.2615384615384615
train,crazing_224.xml,200,200,crazing,49,7,199,103,124.0,55.0,150,96,1.5625
train,crazing_225.xml,200,200,crazing,4,119,173,200,88.5,159.5,169,81,2.0864197530864197
train,crazing_225.xml,200,200,crazing,1,9,165,125,83.0,67.0,164,116,1.4137931034482758
train,crazing_226.xml,200,200,crazing,2,143,172,196,87.0,169.5,170,53,3.207547169811321
train,crazing_226.xml,200,200,crazing,1,19,174,145,87.5,82.0,173,126,1.373015873015873
train,crazing_227.xml,200,200,crazing,12,26,199,96,105.5,61.0,187,70,2.6714285714285713
train,crazing_227.xml,200,200,crazing,130,1,200,125,165.0,63.0,70,124,0.5645161290322581
train,crazing_227.xml,200,200,crazing,34,33,168,159,101.0,96.0,134,126,1.0634920634920635
train,crazing_228.xml,200,200,crazing,18,124,187,192,102.5,158.0,169,68,2.485294117647059
train,crazing_228.xml,200,200,crazing,3,59,161,120,82.0,89.5,158,61,2.5901639344262297
train,crazing_228.xml,200,200,crazing,56,22,199,102,127.5,62.0,143,80,1.7875
train,crazing_229.xml,200,200,crazing,1,58,174,128,87.5,93.0,173,70,2.4714285714285715
train,crazing_229.xml,200,200,crazing,1,6,149,72,75.0,39.0,148,66,2.242424242424242
train,crazing_229.xml,200,200,crazing,1,123,187,198,94.0,160.5,186,75,2.48
train,crazing_23.xml,200,200,crazing,1,6,171,112,86.0,59.0,170,106,1.6037735849056605
train,crazing_23.xml,200,200,crazing,1,122,180,200,90.5,161.0,179,78,2.2948717948717947
train,crazing_230.xml,200,200,crazing,36,28,181,107,108.5,67.5,145,79,1.8354430379746836
train,crazing_230.xml,200,200,crazing,1,104,112,182,56.5,143.0,111,78,1.4230769230769231
train,crazing_231.xml,200,200,crazing,9,98,200,187,104.5,142.5,191,89,2.146067415730337
train,crazing_231.xml,200,200,crazing,85,8,200,88,142.5,48.0,115,80,1.4375
train,crazing_231.xml,200,200,crazing,1,12,137,67,69.0,39.5,136,55,2.4727272727272727
train,crazing_232.xml,200,200,crazing,82,9,200,60,141.0,34.5,118,51,2.3137254901960786
train,crazing_232.xml,200,200,crazing,1,80,134,156,67.5,118.0,133,76,1.75
train,crazing_232.xml,200,200,crazing,1,26,132,88,66.5,57.0,131,62,2.1129032258064515
train,crazing_232.xml,200,200,crazing,1,137,179,182,90.0,159.5,178,45,3.9555555555555557
train,crazing_233.xml,200,200,crazing,6,147,182,191,94.0,169.0,176,44,4.0
train,crazing_233.xml,200,200,crazing,1,21,198,121,99.5,71.0,197,100,1.97
train,crazing_234.xml,200,200,crazing,57,5,199,73,128.0,39.0,142,68,2.088235294117647
train,crazing_234.xml,200,200,crazing,8,76,200,166,104.0,121.0,192,90,2.1333333333333333
train,crazing_235.xml,200,200,crazing,37,1,163,51,100.0,26.0,126,50,2.52
train,crazing_235.xml,200,200,crazing,3,65,179,122,91.0,93.5,176,57,3.087719298245614
train,crazing_235.xml,200,200,crazing,47,145,183,199,115.0,172.0,136,54,2.5185185185185186
train,crazing_235.xml,200,200,crazing,2,3,53,62,27.5,32.5,51,59,0.864406779661017
train,crazing_236.xml,200,200,crazing,5,1,198,70,101.5,35.5,193,69,2.7971014492753623
train,crazing_236.xml,200,200,crazing,1,65,101,136,51.0,100.5,100,71,1.408450704225352
train,crazing_236.xml,200,200,crazing,107,32,200,126,153.5,79.0,93,94,0.9893617021276596
train,crazing_236.xml,200,200,crazing,76,111,200,181,138.0,146.0,124,70,1.7714285714285714
train,crazing_237.xml,200,200,crazing,23,4,166,87,94.5,45.5,143,83,1.7228915662650603
train,crazing_237.xml,200,200,crazing,1,119,171,195,86.0,157.0,170,76,2.236842105263158
train,crazing_237.xml,200,200,crazing,69,7,143,189,106.0,98.0,74,182,0.4065934065934066
train,crazing_238.xml,200,200,crazing,1,91,106,186,53.5,138.5,105,95,1.105263157894737
train,crazing_238.xml,200,200,crazing,1,10,178,74,89.5,42.0,177,64,2.765625
train,crazing_239.xml,200,200,crazing,29,120,166,176,97.5,148.0,137,56,2.4464285714285716
train,crazing_239.xml,200,200,crazing,53,1,200,82,126.5,41.5,147,81,1.8148148148148149
train,crazing_239.xml,200,200,crazing,33,36,181,100,107.0,68.0,148,64,2.3125
train,crazing_239.xml,200,200,crazing,1,72,194,132,97.5,102.0,193,60,3.216666666666667
train,crazing_24.xml,200,200,crazing,1,1,196,63,98.5,32.0,195,62,3.1451612903225805
train,crazing_24.xml,200,200,crazing,2,105,153,157,77.5,131.0,151,52,2.9038461538461537
train,crazing_25.xml,200,200,crazing,1,1,118,45,59.5,23.0,117,44,2.659090909090909
train,crazing_25.xml,200,200,crazing,18,80,159,144,88.5,112.0,141,64,2.203125
train,crazing_26.xml,200,200,crazing,25,1,185,50,105.0,25.5,160,49,3.2653061224489797
train,crazing_26.xml,200,200,crazing,79,82,199,174,139.0,128.0,120,92,1.3043478260869565
train,crazing_27.xml,200,200,crazing,75,18,199,72,137.0,45.0,124,54,2.2962962962962963
train,crazing_27.xml,200,200,crazing,6,74,116,190,61.0,132.0,110,116,0.9482758620689655
train,crazing_28.xml,200,200,crazing,1,40,197,148,99.0,94.0,196,108,1.8148148148148149
train,crazing_28.xml,200,200,crazing,104,1,200,33,152.0,17.0,96,32,3.0
train,crazing_29.xml,200,200,crazing,3,30,145,167,74.0,98.5,142,137,1.0364963503649636
train,crazing_3.xml,200,200,crazing,10,97,200,181,105.0,139.0,190,84,2.261904761904762
train,crazing_30.xml,200,200,crazing,1,94,120,174,60.5,134.0,119,80,1.4875
train,crazing_30.xml,200,200,crazing,131,32,200,165,165.5,98.5,69,133,0.518796992481203
train,crazing_30.xml,200,200,crazing,1,10,134,62,67.5,36.0,133,52,2.5576923076923075
train,crazing_31.xml,200,200,crazing,3,106,166,197,84.5,151.5,163,91,1.7912087912087913
train,crazing_31.xml,200,200,crazing,30,3,200,104,115.0,53.5,170,101,1.683168316831683
train,crazing_32.xml,200,200,crazing,1,91,150,163,75.5,127.0,149,72,2.0694444444444446
train,crazing_32.xml,200,200,crazing,1,2,158,79,79.5,40.5,157,77,2.038961038961039
train,crazing_33.xml,200,200,crazing,35,1,132,85,83.5,43.0,97,84,1.1547619047619047
train,crazing_34.xml,200,200,crazing,27,1,158,84,92.5,42.5,131,83,1.5783132530120483
train,crazing_34.xml,200,200,crazing,2,88,88,168,45.0,128.0,86,80,1.075
train,crazing_34.xml,200,200,crazing,85,143,200,200,142.5,171.5,115,57,2.017543859649123
train,crazing_35.xml,200,200,crazing,1,47,200,99,100.5,73.0,199,52,3.826923076923077
train,crazing_35.xml,200,200,crazing,87,101,200,169,143.5,135.0,113,68,1.661764705882353
train,crazing_35.xml,200,200,crazing,102,1,200,44,151.0,22.5,98,43,2.2790697674418605
train,crazing_36.xml,200,200,crazing,74,93,200,171,137.0,132.0,126,78,1.6153846153846154
train,crazing_37.xml,200,200,crazing,74,51,200,154,137.0,102.5,126,103,1.2233009708737863
train,crazing_38.xml,200,200,crazing,107,82,200,199,153.5,140.5,93,117,0.7948717948717948
train,crazing_38.xml,200,200,crazing,66,1,200,87,133.0,44.0,134,86,1.558139534883721
train,crazing_39.xml,200,200,crazing,5,95,200,191,102.5,143.0,195,96,2.03125
train,crazing_39.xml,200,200,crazing,74,3,200,99,137.0,51.0,126,96,1.3125
train,crazing_4.xml,200,200,crazing,10,3,197,108,103.5,55.5,187,105,1.7809523809523808
train,crazing_4.xml,200,200,crazing,15,110,197,198,106.0,154.0,182,88,2.0681818181818183
train,crazing_40.xml,200,200,crazing,5,120,172,194,88.5,157.0,167,74,2.2567567567567566
train,crazing_40.xml,200,200,crazing,169,49,200,199,184.5,124.0,31,150,0.20666666666666667
train,crazing_41.xml,200,200,crazing,12,45,111,198,61.5,121.5,99,153,0.6470588235294118
train,crazing_41.xml,200,200,crazing,10,1,197,52,103.5,26.5,187,51,3.6666666666666665
train,crazing_42.xml,200,200,crazing,11,15,178,85,94.5,50.0,167,70,2.3857142857142857
train,crazing_43.xml,200,200,crazing,1,115,104,184,52.5,149.5,103,69,1.4927536231884058
train,crazing_43.xml,200,200,crazing,4,3,186,51,95.0,27.0,182,48,3.7916666666666665
train,crazing_43.xml,200,200,crazing,162,48,200,186,181.0,117.0,38,138,0.2753623188405797
train,crazing_44.xml,200,200,crazing,146,19,199,177,172.5,98.0,53,158,0.33544303797468356
train,crazing_44.xml,200,200,crazing,8,3,120,180,64.0,91.5,112,177,0.632768361581921
train,crazing_45.xml,200,200,crazing,2,54,119,172,60.5,113.0,117,118,0.9915254237288136
train,crazing_46.xml,200,200,crazing,11,33,100,103,55.5,68.0,89,70,1.2714285714285714
train,crazing_47.xml,200,200,crazing,4,1,105,149,54.5,75.0,101,148,0.6824324324324325
train,crazing_47.xml,200,200,crazing,1,151,72,199,36.5,175.0,71,48,1.4791666666666667
train,crazing_48.xml,200,200,crazing,7,91,192,183,99.5,137.0,185,92,2.010869565217391
train,crazing_48.xml,200,200,crazing,5,5,195,89,100.0,47.0,190,84,2.261904761904762
train,crazing_49.xml,200,200,crazing,14,42,200,126,107.0,84.0,186,84,2.2142857142857144
train,crazing_49.xml,200,200,crazing,1,136,74,199,37.5,167.5,73,63,1.1587301587301588
train,crazing_5.xml,200,200,crazing,1,113,199,176,100.0,144.5,198,63,3.142857142857143
train,crazing_5.xml,200,200,crazing,15,4,199,102,107.0,53.0,184,98,1.8775510204081634
train,crazing_50.xml,200,200,crazing,2,52,196,137,99.0,94.5,194,85,2.2823529411764705
train,crazing_50.xml,200,200,crazing,5,139,200,199,102.5,169.0,195,60,3.25
train,crazing_51.xml,200,200,crazing,53,120,200,160,126.5,140.0,147,40,3.675
train,crazing_51.xml,200,200,crazing,70,1,177,55,123.5,28.0,107,54,1.9814814814814814
train,crazing_52.xml,200,200,crazing,68,130,200,194,134.0,162.0,132,64,2.0625
train,crazing_52.xml,200,200,crazing,56,3,173,66,114.5,34.5,117,63,1.8571428571428572
train,crazing_53.xml,200,200,crazing,1,121,123,198,62.0,159.5,122,77,1.5844155844155845
train,crazing_53.xml,200,200,crazing,1,33,112,116,56.5,74.5,111,83,1.3373493975903614
train,crazing_54.xml,200,200,crazing,28,76,129,157,78.5,116.5,101,81,1.2469135802469136
train,crazing_54.xml,200,200,crazing,31,26,196,71,113.5,48.5,165,45,3.6666666666666665
train,crazing_55.xml,200,200,crazing,4,74,192,166,98.0,120.0,188,92,2.0434782608695654
train,crazing_55.xml,200,200,crazing,7,9,148,58,77.5,33.5,141,49,2.877551020408163
train,crazing_56.xml,200,200,crazing,1,84,77,156,39.0,120.0,76,72,1.0555555555555556
train,crazing_56.xml,200,200,crazing,1,38,149,103,75.0,70.5,148,65,2.276923076923077
train,crazing_56.xml,200,200,crazing,149,7,199,145,174.0,76.0,50,138,0.36231884057971014
train,crazing_57.xml,200,200,crazing,133,1,200,146,166.5,73.5,67,145,0.46206896551724136
train,crazing_57.xml,200,200,crazing,1,35,114,111,57.5,73.0,113,76,1.486842105263158
train,crazing_58.xml,200,200,crazing,3,134,189,198,96.0,166.0,186,64,2.90625
train,crazing_58.xml,200,200,crazing,1,34,196,126,98.5,80.0,195,92,2.119565217391304
train,crazing_59.xml,200,200,crazing,67,72,200,136,133.5,104.0,133,64,2.078125
train,crazing_6.xml,200,200,crazing,27,3,196,45,111.5,24.0,169,42,4.023809523809524
train,crazing_6.xml,200,200,crazing,11,89,119,199,65.0,144.0,108,110,0.9818181818181818
train,crazing_60.xml,200,200,crazing,110,134,200,199,155.0,166.5,90,65,1.3846153846153846
train,crazing_60.xml,200,200,crazing,30,43,200,131,115.0,87.0,170,88,1.9318181818181819
train,crazing_61.xml,200,200,crazing,74,103,198,166,136.0,134.5,124,63,1.9682539682539681
train,crazing_61.xml,200,200,crazing,28,30,179,95,103.5,62.5,151,65,2.3230769230769233
train,crazing_62.xml,200,200,crazing,142,128,200,174,171.0,151.0,58,46,1.2608695652173914
train,crazing_62.xml,200,200,crazing,1,13,89,83,45.0,48.0,88,70,1.2571428571428571
train,crazing_63.xml,200,200,crazing,40,114,200,197,120.0,155.5,160,83,1.927710843373494
train,crazing_63.xml,200,200,crazing,35,17,171,107,103.0,62.0,136,90,1.511111111111111
train,crazing_64.xml,200,200,crazing,12,71,136,194,74.0,132.5,124,123,1.008130081300813
train,crazing_64.xml,200,200,crazing,3,19,200,88,101.5,53.5,197,69,2.8550724637681157
train,crazing_65.xml,200,200,crazing,3,2,96,62,49.5,32.0,93,60,1.55
train,crazing_65.xml,200,200,crazing,5,78,103,199,54.0,138.5,98,121,0.8099173553719008
train,crazing_65.xml,200,200,crazing,124,3,199,162,161.5,82.5,75,159,0.4716981132075472
train,crazing_66.xml,200,200,crazing,69,68,148,164,108.5,116.0,79,96,0.8229166666666666
train,crazing_66.xml,200,200,crazing,27,13,149,59,88.0,36.0,122,46,2.652173913043478
train,crazing_67.xml,200,200,crazing,7,40,157,145,82.0,92.5,150,105,1.4285714285714286
train,crazing_68.xml,200,200,crazing,78,48,196,142,137.0,95.0,118,94,1.2553191489361701
train,crazing_68.xml,200,200,crazing,36,136,189,194,112.5,165.0,153,58,2.6379310344827585
train,crazing_69.xml,200,200,crazing,1,112,84,187,42.5,149.5,83,75,1.1066666666666667
train,crazing_69.xml,200,200,crazing,9,20,189,97,99.0,58.5,180,77,2.3376623376623376
train,crazing_7.xml,200,200,crazing,1,68,187,163,94.0,115.5,186,95,1.9578947368421054
train,crazing_7.xml,200,200,crazing,1,2,200,65,100.5,33.5,199,63,3.1587301587301586
train,crazing_70.xml,200,200,crazing,34,2,174,80,104.0,41.0,140,78,1.794871794871795
train,crazing_70.xml,200,200,crazing,33,93,108,200,70.5,146.5,75,107,0.7009345794392523
train,crazing_71.xml,200,200,crazing,123,87,199,200,161.0,143.5,76,113,0.672566371681416
train,crazing_71.xml,200,200,crazing,83,2,198,69,140.5,35.5,115,67,1.7164179104477613
train,crazing_71.xml,200,200,crazing,1,5,88,131,44.5,68.0,87,126,0.6904761904761905
train,crazing_72.xml,200,200,crazing,6,48,200,128,103.0,88.0,194,80,2.425
train,crazing_72.xml,200,200,crazing,37,146,182,197,109.5,171.5,145,51,2.843137254901961
train,crazing_73.xml,200,200,crazing,26,70,165,189,95.5,129.5,139,119,1.1680672268907564
train,crazing_73.xml,200,200,crazing,53,41,157,108,105.0,74.5,104,67,1.5522388059701493
train,crazing_74.xml,200,200,crazing,2,43,105,158,53.5,100.5,103,115,0.8956521739130435
train,crazing_74.xml,200,200,crazing,130,52,190,167,160.0,109.5,60,115,0.5217391304347826
train,crazing_75.xml,200,200,crazing,4,54,147,161,75.5,107.5,143,107,1.3364485981308412
train,crazing_75.xml,200,200,crazing,158,24,200,173,179.0,98.5,42,149,0.28187919463087246
train,crazing_76.xml,200,200,crazing,1,107,198,189,99.5,148.0,197,82,2.402439024390244
train,crazing_76.xml,200,200,crazing,73,19,180,81,126.5,50.0,107,62,1.7258064516129032
train,crazing_77.xml,200,200,crazing,25,27,183,163,104.0,95.0,158,136,1.161764705882353
train,crazing_78.xml,200,200,crazing,1,56,197,130,99.0,93.0,196,74,2.6486486486486487
train,crazing_78.xml,200,200,crazing,2,1,60,51,31.0,26.0,58,50,1.16
train,crazing_78.xml,200,200,crazing,130,1,198,43,164.0,22.0,68,42,1.619047619047619
train,crazing_79.xml,200,200,crazing,7,88,113,175,60.0,131.5,106,87,1.2183908045977012
train,crazing_79.xml,200,200,crazing,132,55,200,133,166.0,94.0,68,78,0.8717948717948718
train,crazing_8.xml,200,200,crazing,1,26,179,118,90.0,72.0,178,92,1.934782608695652
train,crazing_8.xml,200,200,crazing,1,121,176,200,88.5,160.5,175,79,2.2151898734177213
train,crazing_80.xml,200,200,crazing,112,69,198,150,155.0,109.5,86,81,1.0617283950617284
train,crazing_81.xml,200,200,crazing,2,84,177,182,89.5,133.0,175,98,1.7857142857142858
train,crazing_82.xml,200,200,crazing,122,41,200,199,161.0,120.0,78,158,0.4936708860759494
train,crazing_82.xml,200,200,crazing,4,83,107,198,55.5,140.5,103,115,0.8956521739130435
train,crazing_83.xml,200,200,crazing,1,29,87,127,44.0,78.0,86,98,0.8775510204081632
train,crazing_83.xml,200,200,crazing,95,1,192,198,143.5,99.5,97,197,0.49238578680203043
train,crazing_83.xml,200,200,crazing,2,1,197,65,99.5,33.0,195,64,3.046875
train,crazing_84.xml,200,200,crazing,31,90,182,198,106.5,144.0,151,108,1.3981481481481481
train,crazing_85.xml,200,200,crazing,9,63,135,183,72.0,123.0,126,120,1.05
train,crazing_85.xml,200,200,crazing,152,41,200,200,176.0,120.5,48,159,0.3018867924528302
train,crazing_85.xml,200,200,crazing,88,5,199,55,143.5,30.0,111,50,2.22
train,crazing_86.xml,200,200,crazing,1,43,154,112,77.5,77.5,153,69,2.217391304347826
train,crazing_86.xml,200,200,crazing,1,97,156,174,78.5,135.5,155,77,2.012987012987013
train,crazing_86.xml,200,200,crazing,127,118,200,163,163.5,140.5,73,45,1.6222222222222222
train,crazing_86.xml,200,200,crazing,1,4,182,72,91.5,38.0,181,68,2.661764705882353
train,crazing_87.xml,200,200,crazing,18,9,146,74,82.0,41.5,128,65,1.9692307692307693
train,crazing_87.xml,200,200,crazing,27,32,176,157,101.5,94.5,149,125,1.192
train,crazing_87.xml,200,200,crazing,22,152,200,196,111.0,174.0,178,44,4.045454545454546
train,crazing_88.xml,200,200,crazing,18,34,200,88,109.0,61.0,182,54,3.3703703703703702
train,crazing_88.xml,200,200,crazing,19,99,200,172,109.5,135.5,181,73,2.4794520547945207
train,crazing_89.xml,200,200,crazing,3,128,110,187,56.5,157.5,107,59,1.8135593220338984
train,crazing_89.xml,200,200,crazing,49,20,192,52,120.5,36.0,143,32,4.46875
train,crazing_9.xml,200,200,crazing,1,24,121,74,61.0,49.0,120,50,2.4
train,crazing_9.xml,200,200,crazing,130,1,200,83,165.0,42.0,70,82,0.8536585365853658
train,crazing_90.xml,200,200,crazing,58,5,155,105,106.5,55.0,97,100,0.97
train,crazing_91.xml,200,200,crazing,32,128,180,182,106.0,155.0,148,54,2.740740740740741
train,crazing_91.xml,200,200,crazing,10,53,198,98,104.0,75.5,188,45,4.177777777777778
train,crazing_91.xml,200,200,crazing,12,10,153,48,82.5,29.0,141,38,3.710526315789474
train,crazing_92.xml,200,200,crazing,8,38,180,105,94.0,71.5,172,67,2.5671641791044775
train,crazing_92.xml,200,200,crazing,9,109,191,197,100.0,153.0,182,88,2.0681818181818183
train,crazing_93.xml,200,200,crazing,2,24,127,122,64.5,73.0,125,98,1.2755102040816326
train,crazing_93.xml,200,200,crazing,5,141,168,198,86.5,169.5,163,57,2.8596491228070176
train,crazing_94.xml,200,200,crazing,9,105,200,167,104.5,136.0,191,62,3.0806451612903225
train,crazing_94.xml,200,200,crazing,1,34,194,75,97.5,54.5,193,41,4.7073170731707314
train,crazing_95.xml,200,200,crazing,5,98,200,181,102.5,139.5,195,83,2.3493975903614457
train,crazing_95.xml,200,200,crazing,1,11,156,83,78.5,47.0,155,72,2.1527777777777777
train,crazing_96.xml,200,200,crazing,1,9,135,106,68.0,57.5,134,97,1.3814432989690721
train,crazing_96.xml,200,200,crazing,1,145,88,200,44.5,172.5,87,55,1.5818181818181818
train,crazing_96.xml,200,200,crazing,74,119,198,170,136.0,144.5,124,51,2.4313725490196076
train,crazing_97.xml,200,200,crazing,3,26,126,95,64.5,60.5,123,69,1.7826086956521738
train,crazing_97.xml,200,200,crazing,132,3,200,89,166.0,46.0,68,86,0.7906976744186046
train,crazing_97.xml,200,200,crazing,47,102,152,188,99.5,145.0,105,86,1.2209302325581395
train,crazing_98.xml,200,200,crazing,1,3,164,44,82.5,23.5,163,41,3.975609756097561
train,crazing_98.xml,200,200,crazing,1,51,159,108,80.0,79.5,158,57,2.7719298245614037
train,crazing_98.xml,200,200,crazing,1,134,198,194,99.5,164.0,197,60,3.283333333333333
train,crazing_98.xml,200,200,crazing,60,76,170,162,115.0,119.0,110,86,1.2790697674418605
train,crazing_99.xml,200,200,crazing,4,110,89,200,46.5,155.0,85,90,0.9444444444444444
train,crazing_99.xml,200,200,crazing,126,49,200,198,163.0,123.5,74,149,0.4966442953020134
train,crazing_99.xml,200,200,crazing,3,2,105,96,54.0,49.0,102,94,1.0851063829787233
train,inclusion_1.xml,200,200,inclusion,33,5,46,36,39.5,20.5,13,31,0.41935483870967744
train,inclusion_1.xml,200,200,inclusion,120,34,130,60,125.0,47.0,10,26,0.38461538461538464
train,inclusion_1.xml,200,200,inclusion,116,115,135,198,125.5,156.5,19,83,0.2289156626506024
train,inclusion_1.xml,200,200,inclusion,115,72,140,116,127.5,94.0,25,44,0.5681818181818182
train,inclusion_10.xml,200,200,inclusion,58,1,81,88,69.5,44.5,23,87,0.26436781609195403
train,inclusion_10.xml,200,200,inclusion,65,100,78,131,71.5,115.5,13,31,0.41935483870967744
train,inclusion_10.xml,200,200,inclusion,149,129,163,158,156.0,143.5,14,29,0.4827586206896552
train,inclusion_100.xml,200,200,inclusion,64,1,126,197,95.0,99.0,62,196,0.3163265306122449
train,inclusion_101.xml,200,200,inclusion,110,1,165,198,137.5,99.5,55,197,0.27918781725888325
train,inclusion_102.xml,200,200,inclusion,28,1,73,198,50.5,99.5,45,197,0.22842639593908629
train,inclusion_102.xml,200,200,inclusion,132,70,147,130,139.5,100.0,15,60,0.25
train,inclusion_103.xml,200,200,inclusion,128,1,179,198,153.5,99.5,51,197,0.25888324873096447
train,inclusion_104.xml,200,200,inclusion,15,1,62,198,38.5,99.5,47,197,0.23857868020304568
train,inclusion_104.xml,200,200,inclusion,50,1,73,82,61.5,41.5,23,81,0.2839506172839506
train,inclusion_104.xml,200,200,inclusion,117,106,134,163,125.5,134.5,17,57,0.2982456140350877
train,inclusion_105.xml,200,200,inclusion,55,73,126,198,90.5,135.5,71,125,0.568
train,inclusion_105.xml,200,200,inclusion,144,55,162,106,153.0,80.5,18,51,0.35294117647058826
train,inclusion_105.xml,200,200,inclusion,52,1,88,80,70.0,40.5,36,79,0.45569620253164556
train,inclusion_105.xml,200,200,inclusion,90,1,116,96,103.0,48.5,26,95,0.2736842105263158
train,inclusion_106.xml,200,200,inclusion,75,10,126,198,100.5,104.0,51,188,0.2712765957446808
train,inclusion_107.xml,200,200,inclusion,43,17,56,74,49.5,45.5,13,57,0.22807017543859648
train,inclusion_107.xml,200,200,inclusion,35,94,50,164,42.5,129.0,15,70,0.21428571428571427
train,inclusion_107.xml,200,200,inclusion,64,106,85,127,74.5,116.5,21,21,1.0
train,inclusion_107.xml,200,200,inclusion,100,125,116,168,108.0,146.5,16,43,0.37209302325581395
train,inclusion_108.xml,200,200,inclusion,96,45,124,142,110.0,93.5,28,97,0.28865979381443296
train,inclusion_108.xml,200,200,inclusion,143,1,177,198,160.0,99.5,34,197,0.17258883248730963
train,inclusion_109.xml,200,200,inclusion,132,1,167,187,149.5,94.0,35,186,0.1881720430107527
train,inclusion_109.xml,200,200,inclusion,39,1,74,198,56.5,99.5,35,197,0.17766497461928935
train,inclusion_109.xml,200,200,inclusion,1,35,28,145,14.5,90.0,27,110,0.24545454545454545
train,inclusion_11.xml,200,200,inclusion,30,23,78,198,54.0,110.5,48,175,0.2742857142857143
train,inclusion_110.xml,200,200,inclusion,98,1,127,77,112.5,39.0,29,76,0.3815789473684211
train,inclusion_110.xml,200,200,inclusion,95,120,138,198,116.5,159.0,43,78,0.5512820512820513
train,inclusion_110.xml,200,200,inclusion,144,1,178,198,161.0,99.5,34,197,0.17258883248730963
train,inclusion_111.xml,200,200,inclusion,92,150,120,198,106.0,174.0,28,48,0.5833333333333334
train,inclusion_111.xml,200,200,inclusion,131,152,153,198,142.0,175.0,22,46,0.4782608695652174
train,inclusion_111.xml,200,200,inclusion,123,1,150,102,136.5,51.5,27,101,0.26732673267326734
train,inclusion_111.xml,200,200,inclusion,3,1,63,198,33.0,99.5,60,197,0.30456852791878175
train,inclusion_112.xml,200,200,inclusion,56,1,87,138,71.5,69.5,31,137,0.22627737226277372
train,inclusion_112.xml,200,200,inclusion,182,8,198,62,190.0,35.0,16,54,0.2962962962962963
train,inclusion_112.xml,200,200,inclusion,94,1,111,49,102.5,25.0,17,48,0.3541666666666667
train,inclusion_113.xml,200,200,inclusion,6,3,49,198,27.5,100.5,43,195,0.2205128205128205
train,inclusion_113.xml,200,200,inclusion,75,120,105,199,90.0,159.5,30,79,0.379746835443038
train,inclusion_113.xml,200,200,inclusion,109,1,136,73,122.5,37.0,27,72,0.375
train,inclusion_113.xml,200,200,inclusion,117,122,133,169,125.0,145.5,16,47,0.3404255319148936
train,inclusion_113.xml,200,200,inclusion,116,160,142,198,129.0,179.0,26,38,0.6842105263157895
train,inclusion_113.xml,200,200,inclusion,167,160,188,198,177.5,179.0,21,38,0.5526315789473685
train,inclusion_114.xml,200,200,inclusion,1,1,29,132,15.0,66.5,28,131,0.21374045801526717
train,inclusion_114.xml,200,200,inclusion,49,77,80,198,64.5,137.5,31,121,0.256198347107438
train,inclusion_114.xml,200,200,inclusion,90,79,107,120,98.5,99.5,17,41,0.4146341463414634
train,inclusion_114.xml,200,200,inclusion,90,114,117,180,103.5,147.0,27,66,0.4090909090909091
train,inclusion_114.xml,200,200,inclusion,139,115,160,192,149.5,153.5,21,77,0.2727272727272727
train,inclusion_114.xml,200,200,inclusion,85,1,102,31,93.5,16.0,17,30,0.5666666666666667
train,inclusion_115.xml,200,200,inclusion,16,59,37,113,26.5,86.0,21,54,0.3888888888888889
train,inclusion_115.xml,200,200,inclusion,45,86,65,195,55.0,140.5,20,109,0.1834862385321101
train,inclusion_115.xml,200,200,inclusion,41,1,82,137,61.5,69.0,41,136,0.3014705882352941
train,inclusion_115.xml,200,200,inclusion,105,74,138,198,121.5,136.0,33,124,0.2661290322580645
train,inclusion_115.xml,200,200,inclusion,144,120,172,181,158.0,150.5,28,61,0.45901639344262296
train,inclusion_115.xml,200,200,inclusion,145,1,159,30,152.0,15.5,14,29,0.4827586206896552
train,inclusion_115.xml,200,200,inclusion,148,80,163,124,155.5,102.0,15,44,0.3409090909090909
train,inclusion_116.xml,200,200,inclusion,71,29,92,86,81.5,57.5,21,57,0.3684210526315789
train,inclusion_116.xml,200,200,inclusion,159,47,191,199,175.0,123.0,32,152,0.21052631578947367
train,inclusion_116.xml,200,200,inclusion,98,1,135,164,116.5,82.5,37,163,0.22699386503067484
train,inclusion_116.xml,200,200,inclusion,102,155,121,199,111.5,177.0,19,44,0.4318181818181818
train,inclusion_117.xml,200,200,inclusion,21,1,55,143,38.0,72.0,34,142,0.23943661971830985
train,inclusion_117.xml,200,200,inclusion,34,146,86,189,60.0,167.5,52,43,1.2093023255813953
train,inclusion_117.xml,200,200,inclusion,62,1,91,90,76.5,45.5,29,89,0.3258426966292135
train,inclusion_117.xml,200,200,inclusion,116,26,133,101,124.5,63.5,17,75,0.22666666666666666
train,inclusion_118.xml,200,200,inclusion,115,2,139,53,127.0,27.5,24,51,0.47058823529411764
train,inclusion_118.xml,200,200,inclusion,144,1,182,180,163.0,90.5,38,179,0.2122905027932961
train,inclusion_118.xml,200,200,inclusion,145,133,171,199,158.0,166.0,26,66,0.3939393939393939
train,inclusion_119.xml,200,200,inclusion,98,1,136,198,117.0,99.5,38,197,0.19289340101522842
train,inclusion_119.xml,200,200,inclusion,74,1,93,46,83.5,23.5,19,45,0.4222222222222222
train,inclusion_119.xml,200,200,inclusion,160,16,194,175,177.0,95.5,34,159,0.2138364779874214
train,inclusion_12.xml,200,200,inclusion,18,4,62,198,40.0,101.0,44,194,0.2268041237113402
train,inclusion_12.xml,200,200,inclusion,75,38,111,182,93.0,110.0,36,144,0.25
train,inclusion_12.xml,200,200,inclusion,138,150,159,198,148.5,174.0,21,48,0.4375
train,inclusion_12.xml,200,200,inclusion,114,100,127,130,120.5,115.0,13,30,0.43333333333333335
train,inclusion_12.xml,200,200,inclusion,149,1,186,124,167.5,62.5,37,123,0.3008130081300813
train,inclusion_120.xml,200,200,inclusion,22,60,60,198,41.0,129.0,38,138,0.2753623188405797
train,inclusion_120.xml,200,200,inclusion,82,1,107,59,94.5,30.0,25,58,0.43103448275862066
train,inclusion_120.xml,200,200,inclusion,115,62,132,101,123.5,81.5,17,39,0.4358974358974359
train,inclusion_120.xml,200,200,inclusion,119,141,144,200,131.5,170.5,25,59,0.423728813559322
train,inclusion_120.xml,200,200,inclusion,150,128,166,177,158.0,152.5,16,49,0.32653061224489793
train,inclusion_120.xml,200,200,inclusion,23,1,56,90,39.5,45.5,33,89,0.3707865168539326
train,inclusion_121.xml,200,200,inclusion,107,16,159,198,133.0,107.0,52,182,0.2857142857142857
train,inclusion_121.xml,200,200,inclusion,78,163,92,198,85.0,180.5,14,35,0.4
train,inclusion_121.xml,200,200,inclusion,79,5,119,134,99.0,69.5,40,129,0.31007751937984496
train,inclusion_122.xml,200,200,inclusion,18,1,71,198,44.5,99.5,53,197,0.26903553299492383
train,inclusion_122.xml,200,200,inclusion,110,75,139,199,124.5,137.0,29,124,0.23387096774193547
train,inclusion_122.xml,200,200,inclusion,134,1,158,95,146.0,48.0,24,94,0.2553191489361702
train,inclusion_122.xml,200,200,inclusion,166,1,179,26,172.5,13.5,13,25,0.52
train,inclusion_123.xml,200,200,inclusion,45,56,76,198,60.5,127.0,31,142,0.21830985915492956
train,inclusion_123.xml,200,200,inclusion,72,1,96,78,84.0,39.5,24,77,0.3116883116883117
train,inclusion_124.xml,200,200,inclusion,113,1,145,87,129.0,44.0,32,86,0.37209302325581395
train,inclusion_124.xml,200,200,inclusion,39,1,58,63,48.5,32.0,19,62,0.3064516129032258
train,inclusion_124.xml,200,200,inclusion,13,90,31,151,22.0,120.5,18,61,0.29508196721311475
train,inclusion_124.xml,200,200,inclusion,39,106,71,197,55.0,151.5,32,91,0.3516483516483517
train,inclusion_124.xml,200,200,inclusion,17,18,39,75,28.0,46.5,22,57,0.38596491228070173
train,inclusion_125.xml,200,200,inclusion,107,15,123,77,115.0,46.0,16,62,0.25806451612903225
train,inclusion_125.xml,200,200,inclusion,88,1,101,27,94.5,14.0,13,26,0.5
train,inclusion_125.xml,200,200,inclusion,130,31,167,114,148.5,72.5,37,83,0.4457831325301205
train,inclusion_125.xml,200,200,inclusion,93,125,127,187,110.0,156.0,34,62,0.5483870967741935
train,inclusion_125.xml,200,200,inclusion,57,31,73,75,65.0,53.0,16,44,0.36363636363636365
train,inclusion_125.xml,200,200,inclusion,33,62,44,86,38.5,74.0,11,24,0.4583333333333333
train,inclusion_125.xml,200,200,inclusion,136,90,154,142,145.0,116.0,18,52,0.34615384615384615
train,inclusion_125.xml,200,200,inclusion,33,90,46,116,39.5,103.0,13,26,0.5
train,inclusion_125.xml,200,200,inclusion,35,145,47,173,41.0,159.0,12,28,0.42857142857142855
train,inclusion_126.xml,200,200,inclusion,2,88,40,160,21.0,124.0,38,72,0.5277777777777778
train,inclusion_126.xml,200,200,inclusion,24,1,43,42,33.5,21.5,19,41,0.4634146341463415
train,inclusion_126.xml,200,200,inclusion,50,1,85,86,67.5,43.5,35,85,0.4117647058823529
train,inclusion_126.xml,200,200,inclusion,94,175,106,198,100.0,186.5,12,23,0.5217391304347826
train,inclusion_126.xml,200,200,inclusion,56,57,74,102,65.0,79.5,18,45,0.4
train,inclusion_127.xml,200,200,inclusion,34,40,48,76,41.0,58.0,14,36,0.3888888888888889
train,inclusion_127.xml,200,200,inclusion,68,90,117,199,92.5,144.5,49,109,0.44954128440366975
train,inclusion_127.xml,200,200,inclusion,100,85,120,125,110.0,105.0,20,40,0.5
train,inclusion_128.xml,200,200,inclusion,31,1,42,25,36.5,13.0,11,24,0.4583333333333333
train,inclusion_128.xml,200,200,inclusion,68,43,117,173,92.5,108.0,49,130,0.3769230769230769
train,inclusion_128.xml,200,200,inclusion,96,40,114,80,105.0,60.0,18,40,0.45
train,inclusion_129.xml,200,200,inclusion,163,108,190,160,176.5,134.0,27,52,0.5192307692307693
train,inclusion_129.xml,200,200,inclusion,23,143,41,199,32.0,171.0,18,56,0.32142857142857145
train,inclusion_129.xml,200,200,inclusion,44,1,92,118,68.0,59.5,48,117,0.41025641025641024
train,inclusion_129.xml,200,200,inclusion,80,96,99,128,89.5,112.0,19,32,0.59375
train,inclusion_13.xml,200,200,inclusion,60,1,98,198,79.0,99.5,38,197,0.19289340101522842
train,inclusion_13.xml,200,200,inclusion,106,2,153,73,129.5,37.5,47,71,0.6619718309859155
train,inclusion_13.xml,200,200,inclusion,160,36,194,187,177.0,111.5,34,151,0.2251655629139073
train,inclusion_13.xml,200,200,inclusion,111,77,136,118,123.5,97.5,25,41,0.6097560975609756
train,inclusion_13.xml,200,200,inclusion,112,126,139,200,125.5,163.0,27,74,0.36486486486486486
train,inclusion_130.xml,200,200,inclusion,87,133,109,191,98.0,162.0,22,58,0.3793103448275862
train,inclusion_130.xml,200,200,inclusion,138,95,155,126,146.5,110.5,17,31,0.5483870967741935
train,inclusion_130.xml,200,200,inclusion,161,114,178,175,169.5,144.5,17,61,0.2786885245901639
train,inclusion_130.xml,200,200,inclusion,168,39,187,100,177.5,69.5,19,61,0.3114754098360656
train,inclusion_130.xml,200,200,inclusion,175,99,197,148,186.0,123.5,22,49,0.4489795918367347
train,inclusion_130.xml,200,200,inclusion,15,7,42,70,28.5,38.5,27,63,0.42857142857142855
train,inclusion_130.xml,200,200,inclusion,89,4,115,68,102.0,36.0,26,64,0.40625
train,inclusion_130.xml,200,200,inclusion,112,132,128,175,120.0,153.5,16,43,0.37209302325581395
train,inclusion_130.xml,200,200,inclusion,184,157,198,192,191.0,174.5,14,35,0.4
train,inclusion_131.xml,200,200,inclusion,39,1,92,197,65.5,99.0,53,196,0.27040816326530615
train,inclusion_132.xml,200,200,inclusion,69,2,115,197,92.0,99.5,46,195,0.2358974358974359
train,inclusion_133.xml,200,200,inclusion,69,1,140,200,104.5,100.5,71,199,0.35678391959798994
train,inclusion_134.xml,200,200,inclusion,53,1,99,199,76.0,100.0,46,198,0.23232323232323232
train,inclusion_134.xml,200,200,inclusion,55,1,84,103,69.5,52.0,29,102,0.28431372549019607
train,inclusion_135.xml,200,200,inclusion,41,1,74,178,57.5,89.5,33,177,0.1864406779661017
train,inclusion_135.xml,200,200,inclusion,60,6,98,198,79.0,102.0,38,192,0.19791666666666666
train,inclusion_136.xml,200,200,inclusion,166,70,188,117,177.0,93.5,22,47,0.46808510638297873
train,inclusion_137.xml,200,200,inclusion,50,1,74,47,62.0,24.0,24,46,0.5217391304347826
train,inclusion_137.xml,200,200,inclusion,96,120,110,145,103.0,132.5,14,25,0.56
train,inclusion_138.xml,200,200,inclusion,138,125,162,180,150.0,152.5,24,55,0.43636363636363634
train,inclusion_138.xml,200,200,inclusion,173,17,187,39,180.0,28.0,14,22,0.6363636363636364
train,inclusion_139.xml,200,200,inclusion,58,140,82,186,70.0,163.0,24,46,0.5217391304347826
train,inclusion_139.xml,200,200,inclusion,67,72,92,125,79.5,98.5,25,53,0.4716981132075472
train,inclusion_139.xml,200,200,inclusion,164,103,179,126,171.5,114.5,15,23,0.6521739130434783
train,inclusion_14.xml,200,200,inclusion,2,9,42,188,22.0,98.5,40,179,0.22346368715083798
train,inclusion_14.xml,200,200,inclusion,91,150,115,194,103.0,172.0,24,44,0.5454545454545454
train,inclusion_140.xml,200,200,inclusion,106,73,129,118,117.5,95.5,23,45,0.5111111111111111
train,inclusion_140.xml,200,200,inclusion,118,6,140,60,129.0,33.0,22,54,0.4074074074074074
train,inclusion_141.xml,200,200,inclusion,104,3,127,47,115.5,25.0,23,44,0.5227272727272727
train,inclusion_141.xml,200,200,inclusion,99,153,121,183,110.0,168.0,22,30,0.7333333333333333
train,inclusion_142.xml,200,200,inclusion,142,130,159,170,150.5,150.0,17,40,0.425
train,inclusion_142.xml,200,200,inclusion,56,34,70,56,63.0,45.0,14,22,0.6363636363636364
train,inclusion_143.xml,200,200,inclusion,42,15,59,39,50.5,27.0,17,24,0.7083333333333334
train,inclusion_143.xml,200,200,inclusion,29,69,50,121,39.5,95.0,21,52,0.40384615384615385
train,inclusion_143.xml,200,200,inclusion,31,124,47,151,39.0,137.5,16,27,0.5925925925925926
train,inclusion_144.xml,200,200,inclusion,128,13,142,41,135.0,27.0,14,28,0.5
train,inclusion_144.xml,200,200,inclusion,113,69,134,123,123.5,96.0,21,54,0.3888888888888889
train,inclusion_144.xml,200,200,inclusion,116,122,130,151,123.0,136.5,14,29,0.4827586206896552
train,inclusion_145.xml,200,200,inclusion,61,94,102,198,81.5,146.0,41,104,0.3942307692307692
train,inclusion_145.xml,200,200,inclusion,53,73,74,139,63.5,106.0,21,66,0.3181818181818182
train,inclusion_145.xml,200,200,inclusion,81,43,97,89,89.0,66.0,16,46,0.34782608695652173
train,inclusion_146.xml,200,200,inclusion,20,132,40,174,30.0,153.0,20,42,0.47619047619047616
train,inclusion_146.xml,200,200,inclusion,91,9,137,194,114.0,101.5,46,185,0.24864864864864866
train,inclusion_146.xml,200,200,inclusion,87,4,112,75,99.5,39.5,25,71,0.352112676056338
train,inclusion_146.xml,200,200,inclusion,122,83,140,128,131.0,105.5,18,45,0.4
train,inclusion_147.xml,200,200,inclusion,74,115,96,161,85.0,138.0,22,46,0.4782608695652174
train,inclusion_147.xml,200,200,inclusion,148,3,194,184,171.0,93.5,46,181,0.2541436464088398
train,inclusion_147.xml,200,200,inclusion,141,1,161,84,151.0,42.5,20,83,0.24096385542168675
train,inclusion_148.xml,200,200,inclusion,15,1,52,97,33.5,49.0,37,96,0.3854166666666667
train,inclusion_148.xml,200,200,inclusion,45,23,62,66,53.5,44.5,17,43,0.3953488372093023
train,inclusion_148.xml,200,200,inclusion,20,70,43,133,31.5,101.5,23,63,0.36507936507936506
train,inclusion_149.xml,200,200,inclusion,55,1,77,62,66.0,31.5,22,61,0.36065573770491804
train,inclusion_149.xml,200,200,inclusion,79,119,99,158,89.0,138.5,20,39,0.5128205128205128
train,inclusion_15.xml,200,200,inclusion,47,1,73,199,60.0,100.0,26,198,0.13131313131313133
train,inclusion_15.xml,200,200,inclusion,93,55,124,200,108.5,127.5,31,145,0.21379310344827587
train,inclusion_15.xml,200,200,inclusion,147,53,169,124,158.0,88.5,22,71,0.30985915492957744
train,inclusion_15.xml,200,200,inclusion,182,43,197,74,189.5,58.5,15,31,0.4838709677419355
train,inclusion_15.xml,200,200,inclusion,95,10,112,50,103.5,30.0,17,40,0.425
train,inclusion_15.xml,200,200,inclusion,161,1,179,44,170.0,22.5,18,43,0.4186046511627907
train,inclusion_150.xml,200,200,inclusion,135,43,180,196,157.5,119.5,45,153,0.29411764705882354
train,inclusion_151.xml,200,200,inclusion,11,13,62,171,36.5,92.0,51,158,0.3227848101265823
train,inclusion_151.xml,200,200,inclusion,76,62,141,200,108.5,131.0,65,138,0.47101449275362317
train,inclusion_151.xml,200,200,inclusion,133,79,156,121,144.5,100.0,23,42,0.5476190476190477
train,inclusion_151.xml,200,200,inclusion,126,119,171,200,148.5,159.5,45,81,0.5555555555555556
train,inclusion_152.xml,200,200,inclusion,18,10,101,198,59.5,104.0,83,188,0.44148936170212766
train,inclusion_152.xml,200,200,inclusion,73,29,98,70,85.5,49.5,25,41,0.6097560975609756
train,inclusion_152.xml,200,200,inclusion,65,67,108,146,86.5,106.5,43,79,0.5443037974683544
train,inclusion_153.xml,200,200,inclusion,22,1,100,198,61.0,99.5,78,197,0.39593908629441626
train,inclusion_153.xml,200,200,inclusion,102,1,118,48,110.0,24.5,16,47,0.3404255319148936
train,inclusion_154.xml,200,200,inclusion,51,54,89,177,70.0,115.5,38,123,0.3089430894308943
train,inclusion_154.xml,200,200,inclusion,92,109,119,195,105.5,152.0,27,86,0.313953488372093
train,inclusion_154.xml,200,200,inclusion,156,1,198,163,177.0,82.0,42,162,0.25925925925925924
train,inclusion_154.xml,200,200,inclusion,96,10,117,58,106.5,34.0,21,48,0.4375
train,inclusion_154.xml,200,200,inclusion,112,75,126,106,119.0,90.5,14,31,0.45161290322580644
train,inclusion_155.xml,200,200,inclusion,86,8,118,78,102.0,43.0,32,70,0.45714285714285713
train,inclusion_155.xml,200,200,inclusion,125,10,154,122,139.5,66.0,29,112,0.25892857142857145
train,inclusion_155.xml,200,200,inclusion,132,113,167,198,149.5,155.5,35,85,0.4117647058823529
train,inclusion_156.xml,200,200,inclusion,11,1,48,148,29.5,74.5,37,147,0.25170068027210885
train,inclusion_156.xml,200,200,inclusion,106,2,142,196,124.0,99.0,36,194,0.18556701030927836
train,inclusion_156.xml,200,200,inclusion,87,1,106,66,96.5,33.5,19,65,0.2923076923076923
train,inclusion_157.xml,200,200,inclusion,17,79,40,169,28.5,124.0,23,90,0.25555555555555554
train,inclusion_157.xml,200,200,inclusion,70,15,92,47,81.0,31.0,22,32,0.6875
train,inclusion_157.xml,200,200,inclusion,71,109,144,197,107.5,153.0,73,88,0.8295454545454546
train,inclusion_157.xml,200,200,inclusion,171,150,189,189,180.0,169.5,18,39,0.46153846153846156
train,inclusion_157.xml,200,200,inclusion,182,1,199,37,190.5,19.0,17,36,0.4722222222222222
train,inclusion_158.xml,200,200,inclusion,79,46,101,136,90.0,91.0,22,90,0.24444444444444444
train,inclusion_158.xml,200,200,inclusion,130,78,198,198,164.0,138.0,68,120,0.5666666666666667
train,inclusion_159.xml,200,200,inclusion,42,52,64,170,53.0,111.0,22,118,0.1864406779661017
train,inclusion_159.xml,200,200,inclusion,67,1,98,198,82.5,99.5,31,197,0.15736040609137056
train,inclusion_16.xml,200,200,inclusion,119,1,146,194,132.5,97.5,27,193,0.13989637305699482
train,inclusion_16.xml,200,200,inclusion,168,1,194,120,181.0,60.5,26,119,0.2184873949579832
train,inclusion_16.xml,200,200,inclusion,173,116,198,198,185.5,157.0,25,82,0.3048780487804878
train,inclusion_160.xml,200,200,inclusion,65,25,90,198,77.5,111.5,25,173,0.14450867052023122
train,inclusion_160.xml,200,200,inclusion,90,25,128,198,109.0,111.5,38,173,0.21965317919075145
train,inclusion_161.xml,200,200,inclusion,47,94,118,199,82.5,146.5,71,105,0.6761904761904762
train,inclusion_161.xml,200,200,inclusion,50,2,80,90,65.0,46.0,30,88,0.3409090909090909
train,inclusion_161.xml,200,200,inclusion,90,1,128,117,109.0,59.0,38,116,0.3275862068965517
train,inclusion_162.xml,200,200,inclusion,21,23,73,170,47.0,96.5,52,147,0.35374149659863946
train,inclusion_162.xml,200,200,inclusion,85,69,138,198,111.5,133.5,53,129,0.4108527131782946
train,inclusion_162.xml,200,200,inclusion,135,123,182,197,158.5,160.0,47,74,0.6351351351351351
train,inclusion_162.xml,200,200,inclusion,142,86,163,131,152.5,108.5,21,45,0.4666666666666667
train,inclusion_163.xml,200,200,inclusion,1,22,33,170,17.0,96.0,32,148,0.21621621621621623
train,inclusion_163.xml,200,200,inclusion,47,70,108,199,77.5,134.5,61,129,0.4728682170542636
train,inclusion_163.xml,200,200,inclusion,102,87,127,130,114.5,108.5,25,43,0.5813953488372093
train,inclusion_163.xml,200,200,inclusion,103,133,141,200,122.0,166.5,38,67,0.5671641791044776
train,inclusion_164.xml,200,200,inclusion,67,1,111,74,89.0,37.5,44,73,0.6027397260273972
train,inclusion_164.xml,200,200,inclusion,136,1,198,198,167.0,99.5,62,197,0.3147208121827411
train,inclusion_164.xml,200,200,inclusion,33,104,84,198,58.5,151.0,51,94,0.5425531914893617
train,inclusion_164.xml,200,200,inclusion,81,83,99,132,90.0,107.5,18,49,0.3673469387755102
train,inclusion_164.xml,200,200,inclusion,93,142,109,180,101.0,161.0,16,38,0.42105263157894735
train,inclusion_165.xml,200,200,inclusion,1,56,21,166,11.0,111.0,20,110,0.18181818181818182
train,inclusion_165.xml,200,200,inclusion,67,1,133,197,100.0,99.0,66,196,0.336734693877551
train,inclusion_165.xml,200,200,inclusion,10,18,25,50,17.5,34.0,15,32,0.46875
train,inclusion_165.xml,200,200,inclusion,122,108,142,168,132.0,138.0,20,60,0.3333333333333333
train,inclusion_165.xml,200,200,inclusion,7,155,28,200,17.5,177.5,21,45,0.4666666666666667
train,inclusion_166.xml,200,200,inclusion,93,6,130,197,111.5,101.5,37,191,0.193717277486911
train,inclusion_166.xml,200,200,inclusion,53,4,86,73,69.5,38.5,33,69,0.4782608695652174
train,inclusion_166.xml,200,200,inclusion,161,100,188,187,174.5,143.5,27,87,0.3103448275862069
train,inclusion_166.xml,200,200,inclusion,171,1,199,64,185.0,32.5,28,63,0.4444444444444444
train,inclusion_167.xml,200,200,inclusion,10,6,53,189,31.5,97.5,43,183,0.23497267759562843
train,inclusion_167.xml,200,200,inclusion,110,1,144,200,127.0,100.5,34,199,0.1708542713567839
train,inclusion_167.xml,200,200,inclusion,92,10,114,86,103.0,48.0,22,76,0.2894736842105263
train,inclusion_168.xml,200,200,inclusion,1,1,44,199,22.5,100.0,43,198,0.21717171717171718
train,inclusion_168.xml,200,200,inclusion,26,55,64,122,45.0,88.5,38,67,0.5671641791044776
train,inclusion_168.xml,200,200,inclusion,10,9,40,47,25.0,28.0,30,38,0.7894736842105263
train,inclusion_169.xml,200,200,inclusion,107,79,136,198,121.5,138.5,29,119,0.24369747899159663
train,inclusion_169.xml,200,200,inclusion,75,156,99,190,87.0,173.0,24,34,0.7058823529411765
train,inclusion_169.xml,200,200,inclusion,102,1,122,35,112.0,18.0,20,34,0.5882352941176471
train,inclusion_17.xml,200,200,inclusion,16,77,39,198,27.5,137.5,23,121,0.19008264462809918
train,inclusion_17.xml,200,200,inclusion,46,124,61,159,53.5,141.5,15,35,0.42857142857142855
train,inclusion_17.xml,200,200,inclusion,123,88,150,136,136.5,112.0,27,48,0.5625
train,inclusion_17.xml,200,200,inclusion,116,163,134,200,125.0,181.5,18,37,0.4864864864864865
train,inclusion_17.xml,200,200,inclusion,70,42,86,74,78.0,58.0,16,32,0.5
train,inclusion_17.xml,200,200,inclusion,21,25,42,85,31.5,55.0,21,60,0.35
train,inclusion_170.xml,200,200,inclusion,77,16,129,199,103.0,107.5,52,183,0.28415300546448086
train,inclusion_171.xml,200,200,inclusion,82,1,123,120,102.5,60.5,41,119,0.3445378151260504
train,inclusion_171.xml,200,200,inclusion,81,134,104,198,92.5,166.0,23,64,0.359375
train,inclusion_172.xml,200,200,inclusion,77,63,106,195,91.5,129.0,29,132,0.2196969696969697
train,inclusion_172.xml,200,200,inclusion,82,13,103,62,92.5,37.5,21,49,0.42857142857142855
train,inclusion_173.xml,200,200,inclusion,155,1,184,130,169.5,65.5,29,129,0.2248062015503876
train,inclusion_173.xml,200,200,inclusion,155,143,177,180,166.0,161.5,22,37,0.5945945945945946
train,inclusion_174.xml,200,200,inclusion,64,1,84,53,74.0,27.0,20,52,0.38461538461538464
train,inclusion_174.xml,200,200,inclusion,66,70,89,107,77.5,88.5,23,37,0.6216216216216216
train,inclusion_175.xml,200,200,inclusion,94,93,140,199,117.0,146.0,46,106,0.4339622641509434
train,inclusion_175.xml,200,200,inclusion,119,74,139,115,129.0,94.5,20,41,0.4878048780487805
train,inclusion_175.xml,200,200,inclusion,92,101,112,165,102.0,133.0,20,64,0.3125
train,inclusion_176.xml,200,200,inclusion,76,35,114,197,95.0,116.0,38,162,0.2345679012345679
train,inclusion_176.xml,200,200,inclusion,65,15,87,103,76.0,59.0,22,88,0.25
train,inclusion_176.xml,200,200,inclusion,99,1,110,23,104.5,12.0,11,22,0.5
train,inclusion_176.xml,200,200,inclusion,2,139,23,178,12.5,158.5,21,39,0.5384615384615384
train,inclusion_176.xml,200,200,inclusion,97,86,117,132,107.0,109.0,20,46,0.43478260869565216
train,inclusion_177.xml,200,200,inclusion,28,34,56,155,42.0,94.5,28,121,0.23140495867768596
train,inclusion_177.xml,200,200,inclusion,146,104,180,164,163.0,134.0,34,60,0.5666666666666667
train,inclusion_177.xml,200,200,inclusion,146,12,170,48,158.0,30.0,24,36,0.6666666666666666
train,inclusion_177.xml,200,200,inclusion,92,38,108,76,100.0,57.0,16,38,0.42105263157894735
train,inclusion_177.xml,200,200,inclusion,150,175,173,199,161.5,187.0,23,24,0.9583333333333334
train,inclusion_178.xml,200,200,inclusion,11,132,38,182,24.5,157.0,27,50,0.54
train,inclusion_178.xml,200,200,inclusion,176,6,199,110,187.5,58.0,23,104,0.22115384615384615
train,inclusion_178.xml,200,200,inclusion,113,130,135,168,124.0,149.0,22,38,0.5789473684210527
train,inclusion_178.xml,200,200,inclusion,10,17,27,44,18.5,30.5,17,27,0.6296296296296297
train,inclusion_179.xml,200,200,inclusion,136,11,155,53,145.5,32.0,19,42,0.4523809523809524
train,inclusion_179.xml,200,200,inclusion,21,130,64,197,42.5,163.5,43,67,0.6417910447761194
train,inclusion_18.xml,200,200,inclusion,156,111,181,198,168.5,154.5,25,87,0.28735632183908044
train,inclusion_18.xml,200,200,inclusion,117,1,143,137,130.0,69.0,26,136,0.19117647058823528
train,inclusion_18.xml,200,200,inclusion,8,1,32,161,20.0,81.0,24,160,0.15
train,inclusion_18.xml,200,200,inclusion,68,155,83,199,75.5,177.0,15,44,0.3409090909090909
train,inclusion_18.xml,200,200,inclusion,72,50,87,72,79.5,61.0,15,22,0.6818181818181818
train,inclusion_18.xml,200,200,inclusion,148,16,162,56,155.0,36.0,14,40,0.35
train,inclusion_18.xml,200,200,inclusion,28,138,51,186,39.5,162.0,23,48,0.4791666666666667
train,inclusion_18.xml,200,200,inclusion,71,118,83,144,77.0,131.0,12,26,0.46153846153846156
train,inclusion_18.xml,200,200,inclusion,69,86,90,113,79.5,99.5,21,27,0.7777777777777778
train,inclusion_180.xml,200,200,inclusion,81,19,111,163,96.0,91.0,30,144,0.20833333333333334
train,inclusion_180.xml,200,200,inclusion,140,51,156,86,148.0,68.5,16,35,0.45714285714285713
train,inclusion_181.xml,200,200,inclusion,27,54,54,183,40.5,118.5,27,129,0.20930232558139536
train,inclusion_181.xml,200,200,inclusion,56,1,83,198,69.5,99.5,27,197,0.13705583756345177
train,inclusion_181.xml,200,200,inclusion,118,11,145,199,131.5,105.0,27,188,0.14361702127659576
train,inclusion_182.xml,200,200,inclusion,136,1,152,67,144.0,34.0,16,66,0.24242424242424243
train,inclusion_182.xml,200,200,inclusion,136,73,164,159,150.0,116.0,28,86,0.32558139534883723
train,inclusion_182.xml,200,200,inclusion,145,166,165,199,155.0,182.5,20,33,0.6060606060606061
train,inclusion_182.xml,200,200,inclusion,162,1,184,198,173.0,99.5,22,197,0.1116751269035533
train,inclusion_183.xml,200,200,inclusion,124,1,180,197,152.0,99.0,56,196,0.2857142857142857
train,inclusion_184.xml,200,200,inclusion,54,1,107,197,80.5,99.0,53,196,0.27040816326530615
train,inclusion_185.xml,200,200,inclusion,27,1,79,183,53.0,92.0,52,182,0.2857142857142857
train,inclusion_186.xml,200,200,inclusion,67,1,105,86,86.0,43.5,38,85,0.4470588235294118
train,inclusion_186.xml,200,200,inclusion,97,130,117,199,107.0,164.5,20,69,0.2898550724637681
train,inclusion_187.xml,200,200,inclusion,25,56,63,195,44.0,125.5,38,139,0.2733812949640288
train,inclusion_188.xml,200,200,inclusion,90,32,129,171,109.5,101.5,39,139,0.2805755395683453
train,inclusion_189.xml,200,200,inclusion,76,1,113,78,94.5,39.5,37,77,0.4805194805194805
train,inclusion_189.xml,200,200,inclusion,76,84,94,138,85.0,111.0,18,54,0.3333333333333333
train,inclusion_189.xml,200,200,inclusion,115,45,129,86,122.0,65.5,14,41,0.34146341463414637
train,inclusion_19.xml,200,200,inclusion,127,1,152,179,139.5,90.0,25,178,0.1404494382022472
train,inclusion_19.xml,200,200,inclusion,173,1,199,91,186.0,46.0,26,90,0.28888888888888886
train,inclusion_19.xml,200,200,inclusion,176,81,192,148,184.0,114.5,16,67,0.23880597014925373
train,inclusion_190.xml,200,200,inclusion,15,31,28,69,21.5,50.0,13,38,0.34210526315789475
train,inclusion_190.xml,200,200,inclusion,26,41,59,198,42.5,119.5,33,157,0.21019108280254778
train,inclusion_190.xml,200,200,inclusion,59,12,103,198,81.0,105.0,44,186,0.23655913978494625
train,inclusion_190.xml,200,200,inclusion,134,1,149,43,141.5,22.0,15,42,0.35714285714285715
train,inclusion_191.xml,200,200,inclusion,163,29,197,197,180.0,113.0,34,168,0.20238095238095238
train,inclusion_191.xml,200,200,inclusion,150,16,166,59,158.0,37.5,16,43,0.37209302325581395
train,inclusion_192.xml,200,200,inclusion,51,1,71,63,61.0,32.0,20,62,0.3225806451612903
train,inclusion_192.xml,200,200,inclusion,6,1,36,66,21.0,33.5,30,65,0.46153846153846156
train,inclusion_192.xml,200,200,inclusion,24,64,52,188,38.0,126.0,28,124,0.22580645161290322
train,inclusion_193.xml,200,200,inclusion,121,20,145,131,133.0,75.5,24,111,0.21621621621621623
train,inclusion_193.xml,200,200,inclusion,161,34,190,151,175.5,92.5,29,117,0.24786324786324787
train,inclusion_193.xml,200,200,inclusion,147,1,164,30,155.5,15.5,17,29,0.5862068965517241
train,inclusion_194.xml,200,200,inclusion,30,69,56,194,43.0,131.5,26,125,0.208
train,inclusion_194.xml,200,200,inclusion,122,40,148,117,135.0,78.5,26,77,0.33766233766233766
train,inclusion_195.xml,200,200,inclusion,56,54,94,167,75.0,110.5,38,113,0.336283185840708
train,inclusion_196.xml,200,200,inclusion,125,44,149,198,137.0,121.0,24,154,0.15584415584415584
train,inclusion_196.xml,200,200,inclusion,34,63,52,113,43.0,88.0,18,50,0.36
train,inclusion_196.xml,200,200,inclusion,166,75,198,196,182.0,135.5,32,121,0.2644628099173554
train,inclusion_196.xml,200,200,inclusion,130,8,151,65,140.5,36.5,21,57,0.3684210526315789
train,inclusion_197.xml,200,200,inclusion,71,25,115,198,93.0,111.5,44,173,0.2543352601156069
train,inclusion_198.xml,200,200,inclusion,53,10,115,198,84.0,104.0,62,188,0.32978723404255317
train,inclusion_198.xml,200,200,inclusion,157,118,175,157,166.0,137.5,18,39,0.46153846153846156
train,inclusion_199.xml,200,200,inclusion,46,1,85,197,65.5,99.0,39,196,0.1989795918367347
train,inclusion_199.xml,200,200,inclusion,26,1,46,51,36.0,26.0,20,50,0.4
train,inclusion_2.xml,200,200,inclusion,23,98,39,132,31.0,115.0,16,34,0.47058823529411764
train,inclusion_2.xml,200,200,inclusion,106,166,132,199,119.0,182.5,26,33,0.7878787878787878
train,inclusion_20.xml,200,200,inclusion,64,1,100,198,82.0,99.5,36,197,0.18274111675126903
train,inclusion_20.xml,200,200,inclusion,123,1,149,160,136.0,80.5,26,159,0.16352201257861634
train,inclusion_20.xml,200,200,inclusion,162,48,198,198,180.0,123.0,36,150,0.24
train,inclusion_20.xml,200,200,inclusion,124,157,142,200,133.0,178.5,18,43,0.4186046511627907
train,inclusion_200.xml,200,200,inclusion,135,1,181,198,158.0,99.5,46,197,0.233502538071066
train,inclusion_201.xml,200,200,inclusion,52,1,105,198,78.5,99.5,53,197,0.26903553299492383
train,inclusion_201.xml,200,200,inclusion,117,94,139,168,128.0,131.0,22,74,0.2972972972972973
train,inclusion_202.xml,200,200,inclusion,27,1,82,199,54.5,100.0,55,198,0.2777777777777778
train,inclusion_203.xml,200,200,inclusion,33,3,76,197,54.5,100.0,43,194,0.22164948453608246
train,inclusion_204.xml,200,200,inclusion,111,38,136,154,123.5,96.0,25,116,0.21551724137931033
train,inclusion_204.xml,200,200,inclusion,18,174,38,198,28.0,186.0,20,24,0.8333333333333334
train,inclusion_205.xml,200,200,inclusion,20,64,45,184,32.5,124.0,25,120,0.20833333333333334
train,inclusion_205.xml,200,200,inclusion,127,11,170,198,148.5,104.5,43,187,0.22994652406417113
train,inclusion_206.xml,200,200,inclusion,25,113,45,184,35.0,148.5,20,71,0.28169014084507044
train,inclusion_206.xml,200,200,inclusion,76,97,96,160,86.0,128.5,20,63,0.31746031746031744
train,inclusion_206.xml,200,200,inclusion,172,1,192,78,182.0,39.5,20,77,0.2597402597402597
train,inclusion_207.xml,200,200,inclusion,74,14,102,71,88.0,42.5,28,57,0.49122807017543857
train,inclusion_207.xml,200,200,inclusion,103,8,124,39,113.5,23.5,21,31,0.6774193548387096
train,inclusion_207.xml,200,200,inclusion,115,143,150,187,132.5,165.0,35,44,0.7954545454545454
train,inclusion_207.xml,200,200,inclusion,77,109,93,140,85.0,124.5,16,31,0.5161290322580645
train,inclusion_208.xml,200,200,inclusion,87,1,107,47,97.0,24.0,20,46,0.43478260869565216
train,inclusion_208.xml,200,200,inclusion,42,79,107,198,74.5,138.5,65,119,0.5462184873949579
train,inclusion_209.xml,200,200,inclusion,33,3,84,198,58.5,100.5,51,195,0.26153846153846155
train,inclusion_209.xml,200,200,inclusion,80,69,104,115,92.0,92.0,24,46,0.5217391304347826
train,inclusion_21.xml,200,200,inclusion,51,1,94,193,72.5,97.0,43,192,0.22395833333333334
train,inclusion_21.xml,200,200,inclusion,105,1,132,198,118.5,99.5,27,197,0.13705583756345177
train,inclusion_21.xml,200,200,inclusion,143,1,190,196,166.5,98.5,47,195,0.24102564102564103
train,inclusion_21.xml,200,200,inclusion,19,163,37,199,28.0,181.0,18,36,0.5
train,inclusion_210.xml,200,200,inclusion,90,31,133,171,111.5,101.0,43,140,0.30714285714285716
train,inclusion_211.xml,200,200,inclusion,71,1,108,72,89.5,36.5,37,71,0.5211267605633803
train,inclusion_211.xml,200,200,inclusion,88,117,125,199,106.5,158.0,37,82,0.45121951219512196
train,inclusion_212.xml,200,200,inclusion,43,43,78,163,60.5,103.0,35,120,0.2916666666666667
train,inclusion_212.xml,200,200,inclusion,162,85,185,126,173.5,105.5,23,41,0.5609756097560976
train,inclusion_213.xml,200,200,inclusion,119,56,146,199,132.5,127.5,27,143,0.1888111888111888
train,inclusion_213.xml,200,200,inclusion,28,79,49,128,38.5,103.5,21,49,0.42857142857142855
train,inclusion_213.xml,200,200,inclusion,124,24,147,96,135.5,60.0,23,72,0.3194444444444444
train,inclusion_214.xml,200,200,inclusion,70,26,108,197,89.0,111.5,38,171,0.2222222222222222
train,inclusion_214.xml,200,200,inclusion,38,140,56,182,47.0,161.0,18,42,0.42857142857142855
train,inclusion_215.xml,200,200,inclusion,77,1,126,199,101.5,100.0,49,198,0.2474747474747475
train,inclusion_215.xml,200,200,inclusion,59,136,83,199,71.0,167.5,24,63,0.38095238095238093
train,inclusion_215.xml,200,200,inclusion,61,13,82,63,71.5,38.0,21,50,0.42
train,inclusion_216.xml,200,200,inclusion,44,1,107,197,75.5,99.0,63,196,0.32142857142857145
train,inclusion_216.xml,200,200,inclusion,147,67,168,110,157.5,88.5,21,43,0.4883720930232558
train,inclusion_217.xml,200,200,inclusion,55,1,108,195,81.5,98.0,53,194,0.27319587628865977
train,inclusion_217.xml,200,200,inclusion,42,1,72,90,57.0,45.5,30,89,0.33707865168539325
train,inclusion_218.xml,200,200,inclusion,56,71,93,144,74.5,107.5,37,73,0.5068493150684932
train,inclusion_218.xml,200,200,inclusion,109,65,139,145,124.0,105.0,30,80,0.375
train,inclusion_218.xml,200,200,inclusion,89,73,113,112,101.0,92.5,24,39,0.6153846153846154
train,inclusion_219.xml,200,200,inclusion,110,93,133,179,121.5,136.0,23,86,0.26744186046511625
train,inclusion_219.xml,200,200,inclusion,87,52,108,91,97.5,71.5,21,39,0.5384615384615384
train,inclusion_22.xml,200,200,inclusion,48,4,94,181,71.0,92.5,46,177,0.2598870056497175
train,inclusion_22.xml,200,200,inclusion,99,52,124,110,111.5,81.0,25,58,0.43103448275862066
train,inclusion_22.xml,200,200,inclusion,144,2,189,188,166.5,95.0,45,186,0.24193548387096775
train,inclusion_22.xml,200,200,inclusion,24,20,45,103,34.5,61.5,21,83,0.25301204819277107
train,inclusion_220.xml,200,200,inclusion,53,11,96,199,74.5,105.0,43,188,0.22872340425531915
train,inclusion_220.xml,200,200,inclusion,41,5,57,33,49.0,19.0,16,28,0.5714285714285714
train,inclusion_221.xml,200,200,inclusion,35,61,61,195,48.0,128.0,26,134,0.19402985074626866
train,inclusion_221.xml,200,200,inclusion,138,12,182,199,160.0,105.5,44,187,0.23529411764705882
train,inclusion_221.xml,200,200,inclusion,127,11,143,34,135.0,22.5,16,23,0.6956521739130435
train,inclusion_222.xml,200,200,inclusion,122,30,149,166,135.5,98.0,27,136,0.19852941176470587
train,inclusion_222.xml,200,200,inclusion,27,177,49,199,38.0,188.0,22,22,1.0
train,inclusion_223.xml,200,200,inclusion,58,14,79,84,68.5,49.0,21,70,0.3
train,inclusion_223.xml,200,200,inclusion,53,115,78,177,65.5,146.0,25,62,0.4032258064516129
train,inclusion_223.xml,200,200,inclusion,110,1,131,63,120.5,32.0,21,62,0.3387096774193548
train,inclusion_223.xml,200,200,inclusion,84,111,102,142,93.0,126.5,18,31,0.5806451612903226
train,inclusion_224.xml,200,200,inclusion,79,42,126,198,102.5,120.0,47,156,0.30128205128205127
train,inclusion_224.xml,200,200,inclusion,70,26,87,67,78.5,46.5,17,41,0.4146341463414634
train,inclusion_225.xml,200,200,inclusion,28,2,64,194,46.0,98.0,36,192,0.1875
train,inclusion_225.xml,200,200,inclusion,68,14,84,74,76.0,44.0,16,60,0.26666666666666666
train,inclusion_226.xml,200,200,inclusion,29,16,67,199,48.0,107.5,38,183,0.20765027322404372
train,inclusion_227.xml,200,200,inclusion,30,155,48,199,39.0,177.0,18,44,0.4090909090909091
train,inclusion_227.xml,200,200,inclusion,65,2,95,65,80.0,33.5,30,63,0.47619047619047616
train,inclusion_228.xml,200,200,inclusion,93,94,108,130,100.5,112.0,15,36,0.4166666666666667
train,inclusion_229.xml,200,200,inclusion,31,23,58,184,44.5,103.5,27,161,0.16770186335403728
train,inclusion_23.xml,200,200,inclusion,23,10,87,199,55.0,104.5,64,189,0.3386243386243386
train,inclusion_23.xml,200,200,inclusion,109,98,132,198,120.5,148.0,23,100,0.23
train,inclusion_23.xml,200,200,inclusion,164,67,194,190,179.0,128.5,30,123,0.24390243902439024
train,inclusion_23.xml,200,200,inclusion,75,16,93,75,84.0,45.5,18,59,0.3050847457627119
train,inclusion_230.xml,200,200,inclusion,31,1,62,179,46.5,90.0,31,178,0.17415730337078653
train,inclusion_230.xml,200,200,inclusion,143,13,159,54,151.0,33.5,16,41,0.3902439024390244
train,inclusion_231.xml,200,200,inclusion,111,86,128,129,119.5,107.5,17,43,0.3953488372093023
train,inclusion_232.xml,200,200,inclusion,27,43,44,94,35.5,68.5,17,51,0.3333333333333333
train,inclusion_232.xml,200,200,inclusion,133,97,152,151,142.5,124.0,19,54,0.35185185185185186
train,inclusion_232.xml,200,200,inclusion,6,101,37,166,21.5,133.5,31,65,0.47692307692307695
train,inclusion_232.xml,200,200,inclusion,134,1,149,34,141.5,17.5,15,33,0.45454545454545453
train,inclusion_233.xml,200,200,inclusion,171,63,188,113,179.5,88.0,17,50,0.34
train,inclusion_233.xml,200,200,inclusion,43,68,75,128,59.0,98.0,32,60,0.5333333333333333
train,inclusion_233.xml,200,200,inclusion,67,14,81,56,74.0,35.0,14,42,0.3333333333333333
train,inclusion_234.xml,200,200,inclusion,84,24,122,87,103.0,55.5,38,63,0.6031746031746031
train,inclusion_234.xml,200,200,inclusion,83,148,131,200,107.0,174.0,48,52,0.9230769230769231
train,inclusion_235.xml,200,200,inclusion,77,94,130,179,103.5,136.5,53,85,0.6235294117647059
train,inclusion_236.xml,200,200,inclusion,14,12,72,92,43.0,52.0,58,80,0.725
train,inclusion_238.xml,200,200,inclusion,101,97,124,158,112.5,127.5,23,61,0.3770491803278688
train,inclusion_238.xml,200,200,inclusion,88,56,116,117,102.0,86.5,28,61,0.45901639344262296
train,inclusion_239.xml,200,200,inclusion,97,54,114,90,105.5,72.0,17,36,0.4722222222222222
train,inclusion_24.xml,200,200,inclusion,18,1,52,80,35.0,40.5,34,79,0.43037974683544306
train,inclusion_24.xml,200,200,inclusion,26,121,53,199,39.5,160.0,27,78,0.34615384615384615
train,inclusion_24.xml,200,200,inclusion,62,93,105,198,83.5,145.5,43,105,0.4095238095238095
train,inclusion_24.xml,200,200,inclusion,96,1,121,63,108.5,32.0,25,62,0.4032258064516129
train,inclusion_24.xml,200,200,inclusion,131,1,171,194,151.0,97.5,40,193,0.20725388601036268
train,inclusion_24.xml,200,200,inclusion,82,38,98,91,90.0,64.5,16,53,0.3018867924528302
train,inclusion_25.xml,200,200,inclusion,13,3,39,142,26.0,72.5,26,139,0.18705035971223022
train,inclusion_25.xml,200,200,inclusion,60,1,83,46,71.5,23.5,23,45,0.5111111111111111
train,inclusion_25.xml,200,200,inclusion,105,2,143,167,124.0,84.5,38,165,0.23030303030303031
train,inclusion_25.xml,200,200,inclusion,28,169,44,200,36.0,184.5,16,31,0.5161290322580645
train,inclusion_25.xml,200,200,inclusion,173,105,193,175,183.0,140.0,20,70,0.2857142857142857
train,inclusion_26.xml,200,200,inclusion,84,18,114,65,99.0,41.5,30,47,0.6382978723404256
train,inclusion_26.xml,200,200,inclusion,8,54,23,92,15.5,73.0,15,38,0.39473684210526316
train,inclusion_26.xml,200,200,inclusion,80,98,97,143,88.5,120.5,17,45,0.37777777777777777
train,inclusion_26.xml,200,200,inclusion,24,147,40,199,32.0,173.0,16,52,0.3076923076923077
train,inclusion_27.xml,200,200,inclusion,52,93,79,197,65.5,145.0,27,104,0.25961538461538464
train,inclusion_27.xml,200,200,inclusion,14,72,37,126,25.5,99.0,23,54,0.42592592592592593
train,inclusion_27.xml,200,200,inclusion,92,125,107,170,99.5,147.5,15,45,0.3333333333333333
train,inclusion_27.xml,200,200,inclusion,151,46,172,110,161.5,78.0,21,64,0.328125
train,inclusion_27.xml,200,200,inclusion,105,1,129,96,117.0,48.5,24,95,0.25263157894736843
train,inclusion_27.xml,200,200,inclusion,57,23,78,57,67.5,40.0,21,34,0.6176470588235294
train,inclusion_27.xml,200,200,inclusion,146,104,166,156,156.0,130.0,20,52,0.38461538461538464
train,inclusion_27.xml,200,200,inclusion,62,51,75,82,68.5,66.5,13,31,0.41935483870967744
train,inclusion_28.xml,200,200,inclusion,35,1,69,198,52.0,99.5,34,197,0.17258883248730963
train,inclusion_28.xml,200,200,inclusion,87,13,112,75,99.5,44.0,25,62,0.4032258064516129
train,inclusion_28.xml,200,200,inclusion,105,54,129,95,117.0,74.5,24,41,0.5853658536585366
train,inclusion_28.xml,200,200,inclusion,86,107,107,157,96.5,132.0,21,50,0.42
train,inclusion_28.xml,200,200,inclusion,94,159,117,199,105.5,179.0,23,40,0.575
train,inclusion_28.xml,200,200,inclusion,147,71,166,147,156.5,109.0,19,76,0.25
train,inclusion_28.xml,200,200,inclusion,180,101,196,144,188.0,122.5,16,43,0.37209302325581395
train,inclusion_28.xml,200,200,inclusion,150,30,168,62,159.0,46.0,18,32,0.5625
train,inclusion_28.xml,200,200,inclusion,143,147,161,193,152.0,170.0,18,46,0.391304347826087
train,inclusion_29.xml,200,200,inclusion,54,5,92,196,73.0,100.5,38,191,0.19895287958115182
train,inclusion_29.xml,200,200,inclusion,102,27,142,197,122.0,112.0,40,170,0.23529411764705882
train,inclusion_29.xml,200,200,inclusion,171,101,193,164,182.0,132.5,22,63,0.3492063492063492
train,inclusion_29.xml,200,200,inclusion,172,7,190,42,181.0,24.5,18,35,0.5142857142857142
train,inclusion_29.xml,200,200,inclusion,125,16,145,87,135.0,51.5,20,71,0.28169014084507044
train,inclusion_3.xml,200,200,inclusion,22,16,36,44,29.0,30.0,14,28,0.5
train,inclusion_3.xml,200,200,inclusion,18,93,42,186,30.0,139.5,24,93,0.25806451612903225
train,inclusion_3.xml,200,200,inclusion,19,53,45,95,32.0,74.0,26,42,0.6190476190476191
train,inclusion_30.xml,200,200,inclusion,87,2,124,187,105.5,94.5,37,185,0.2
train,inclusion_31.xml,200,200,inclusion,50,44,81,141,65.5,92.5,31,97,0.31958762886597936
train,inclusion_31.xml,200,200,inclusion,63,1,82,36,72.5,18.5,19,35,0.5428571428571428
train,inclusion_31.xml,200,200,inclusion,131,86,175,192,153.0,139.0,44,106,0.41509433962264153
train,inclusion_31.xml,200,200,inclusion,141,1,181,87,161.0,44.0,40,86,0.46511627906976744
train,inclusion_31.xml,200,200,inclusion,2,74,26,148,14.0,111.0,24,74,0.32432432432432434
train,inclusion_31.xml,200,200,inclusion,122,141,137,182,129.5,161.5,15,41,0.36585365853658536
train,inclusion_32.xml,200,200,inclusion,35,1,71,199,53.0,100.0,36,198,0.18181818181818182
train,inclusion_32.xml,200,200,inclusion,88,1,119,139,103.5,70.0,31,138,0.2246376811594203
train,inclusion_32.xml,200,200,inclusion,141,1,170,67,155.5,34.0,29,66,0.4393939393939394
train,inclusion_32.xml,200,200,inclusion,114,87,136,165,125.0,126.0,22,78,0.28205128205128205
train,inclusion_32.xml,200,200,inclusion,43,159,67,199,55.0,179.0,24,40,0.6
train,inclusion_33.xml,200,200,inclusion,66,5,98,196,82.0,100.5,32,191,0.16753926701570682
train,inclusion_33.xml,200,200,inclusion,113,4,144,111,128.5,57.5,31,107,0.2897196261682243
train,inclusion_33.xml,200,200,inclusion,142,55,167,129,154.5,92.0,25,74,0.33783783783783783
train,inclusion_34.xml,200,200,inclusion,129,72,166,182,147.5,127.0,37,110,0.33636363636363636
train,inclusion_34.xml,200,200,inclusion,20,41,54,171,37.0,106.0,34,130,0.26153846153846155
train,inclusion_34.xml,200,200,inclusion,69,104,97,163,83.0,133.5,28,59,0.4745762711864407
train,inclusion_34.xml,200,200,inclusion,89,10,109,59,99.0,34.5,20,49,0.40816326530612246
train,inclusion_35.xml,200,200,inclusion,119,5,157,96,138.0,50.5,38,91,0.4175824175824176
train,inclusion_35.xml,200,200,inclusion,148,2,191,196,169.5,99.0,43,194,0.22164948453608246
train,inclusion_35.xml,200,200,inclusion,118,127,141,196,129.5,161.5,23,69,0.3333333333333333
train,inclusion_36.xml,200,200,inclusion,38,2,109,197,73.5,99.5,71,195,0.3641025641025641
train,inclusion_36.xml,200,200,inclusion,120,3,148,100,134.0,51.5,28,97,0.28865979381443296
train,inclusion_36.xml,200,200,inclusion,130,115,153,199,141.5,157.0,23,84,0.27380952380952384
train,inclusion_36.xml,200,200,inclusion,174,1,199,152,186.5,76.5,25,151,0.16556291390728478
train,inclusion_37.xml,200,200,inclusion,63,2,94,77,78.5,39.5,31,75,0.41333333333333333
train,inclusion_37.xml,200,200,inclusion,8,3,48,197,28.0,100.0,40,194,0.20618556701030927
train,inclusion_37.xml,200,200,inclusion,68,90,95,198,81.5,144.0,27,108,0.25
train,inclusion_37.xml,200,200,inclusion,120,3,163,197,141.5,100.0,43,194,0.22164948453608246
train,inclusion_37.xml,200,200,inclusion,174,2,193,147,183.5,74.5,19,145,0.1310344827586207
train,inclusion_38.xml,200,200,inclusion,17,1,64,199,40.5,100.0,47,198,0.23737373737373738
train,inclusion_38.xml,200,200,inclusion,71,77,92,147,81.5,112.0,21,70,0.3
train,inclusion_38.xml,200,200,inclusion,143,2,181,197,162.0,99.5,38,195,0.19487179487179487
train,inclusion_38.xml,200,200,inclusion,105,75,120,105,112.5,90.0,15,30,0.5
train,inclusion_39.xml,200,200,inclusion,12,21,40,193,26.0,107.0,28,172,0.16279069767441862
train,inclusion_39.xml,200,200,inclusion,48,5,85,142,66.5,73.5,37,137,0.27007299270072993
train,inclusion_39.xml,200,200,inclusion,114,2,149,192,131.5,97.0,35,190,0.18421052631578946
train,inclusion_4.xml,200,200,inclusion,91,43,112,140,101.5,91.5,21,97,0.21649484536082475
train,inclusion_4.xml,200,200,inclusion,94,2,119,44,106.5,23.0,25,42,0.5952380952380952
train,inclusion_40.xml,200,200,inclusion,21,4,44,68,32.5,36.0,23,64,0.359375
train,inclusion_40.xml,200,200,inclusion,65,29,104,199,84.5,114.0,39,170,0.22941176470588234
train,inclusion_40.xml,200,200,inclusion,16,64,38,111,27.0,87.5,22,47,0.46808510638297873
train,inclusion_41.xml,200,200,inclusion,56,57,82,123,69.0,90.0,26,66,0.3939393939393939
train,inclusion_41.xml,200,200,inclusion,89,1,126,191,107.5,96.0,37,190,0.19473684210526315
train,inclusion_41.xml,200,200,inclusion,130,85,161,159,145.5,122.0,31,74,0.4189189189189189
train,inclusion_41.xml,200,200,inclusion,156,1,174,79,165.0,40.0,18,78,0.23076923076923078
train,inclusion_41.xml,200,200,inclusion,182,4,198,155,190.0,79.5,16,151,0.10596026490066225
train,inclusion_42.xml,200,200,inclusion,7,30,28,102,17.5,66.0,21,72,0.2916666666666667
train,inclusion_42.xml,200,200,inclusion,122,114,146,191,134.0,152.5,24,77,0.3116883116883117
train,inclusion_42.xml,200,200,inclusion,36,6,62,89,49.0,47.5,26,83,0.3132530120481928
train,inclusion_42.xml,200,200,inclusion,160,60,176,102,168.0,81.0,16,42,0.38095238095238093
train,inclusion_43.xml,200,200,inclusion,18,120,41,195,29.5,157.5,23,75,0.30666666666666664
train,inclusion_43.xml,200,200,inclusion,1,1,23,196,12.0,98.5,22,195,0.11282051282051282
train,inclusion_43.xml,200,200,inclusion,29,22,57,182,43.0,102.0,28,160,0.175
train,inclusion_43.xml,200,200,inclusion,96,72,124,160,110.0,116.0,28,88,0.3181818181818182
train,inclusion_43.xml,200,200,inclusion,148,50,177,149,162.5,99.5,29,99,0.29292929292929293
train,inclusion_43.xml,200,200,inclusion,102,1,122,37,112.0,19.0,20,36,0.5555555555555556
train,inclusion_43.xml,200,200,inclusion,52,3,78,79,65.0,41.0,26,76,0.34210526315789475
train,inclusion_43.xml,200,200,inclusion,165,1,184,38,174.5,19.5,19,37,0.5135135135135135
train,inclusion_44.xml,200,200,inclusion,32,77,65,181,48.5,129.0,33,104,0.3173076923076923
train,inclusion_44.xml,200,200,inclusion,49,32,70,73,59.5,52.5,21,41,0.5121951219512195
train,inclusion_44.xml,200,200,inclusion,116,6,162,199,139.0,102.5,46,193,0.23834196891191708
train,inclusion_45.xml,200,200,inclusion,56,1,89,117,72.5,59.0,33,116,0.28448275862068967
train,inclusion_45.xml,200,200,inclusion,2,8,37,148,19.5,78.0,35,140,0.25
train,inclusion_45.xml,200,200,inclusion,53,129,75,197,64.0,163.0,22,68,0.3235294117647059
train,inclusion_45.xml,200,200,inclusion,148,54,172,113,160.0,83.5,24,59,0.4067796610169492
train,inclusion_45.xml,200,200,inclusion,84,6,107,88,95.5,47.0,23,82,0.2804878048780488
train,inclusion_45.xml,200,200,inclusion,27,78,44,114,35.5,96.0,17,36,0.4722222222222222
train,inclusion_45.xml,200,200,inclusion,103,147,120,176,111.5,161.5,17,29,0.5862068965517241
train,inclusion_46.xml,200,200,inclusion,27,1,54,167,40.5,84.0,27,166,0.16265060240963855
train,inclusion_46.xml,200,200,inclusion,59,9,97,196,78.0,102.5,38,187,0.20320855614973263
train,inclusion_47.xml,200,200,inclusion,103,11,136,198,119.5,104.5,33,187,0.17647058823529413
train,inclusion_47.xml,200,200,inclusion,139,1,172,181,155.5,91.0,33,180,0.18333333333333332
train,inclusion_47.xml,200,200,inclusion,99,1,122,47,110.5,24.0,23,46,0.5
train,inclusion_48.xml,200,200,inclusion,48,1,83,198,65.5,99.5,35,197,0.17766497461928935
train,inclusion_48.xml,200,200,inclusion,86,1,111,155,98.5,78.0,25,154,0.16233766233766234
train,inclusion_49.xml,200,200,inclusion,133,3,178,197,155.5,100.0,45,194,0.23195876288659795
train,inclusion_5.xml,200,200,inclusion,141,89,166,186,153.5,137.5,25,97,0.25773195876288657
train,inclusion_5.xml,200,200,inclusion,143,11,158,39,150.5,25.0,15,28,0.5357142857142857
train,inclusion_5.xml,200,200,inclusion,140,49,168,90,154.0,69.5,28,41,0.6829268292682927
train,inclusion_50.xml,200,200,inclusion,77,1,118,196,97.5,98.5,41,195,0.21025641025641026
train,inclusion_51.xml,200,200,inclusion,30,2,70,197,50.0,99.5,40,195,0.20512820512820512
train,inclusion_52.xml,200,200,inclusion,81,1,124,197,102.5,99.0,43,196,0.2193877551020408
train,inclusion_53.xml,200,200,inclusion,22,1,58,172,40.0,86.5,36,171,0.21052631578947367
train,inclusion_54.xml,200,200,inclusion,79,1,108,90,93.5,45.5,29,89,0.3258426966292135
train,inclusion_54.xml,200,200,inclusion,82,77,116,199,99.0,138.0,34,122,0.2786885245901639
train,inclusion_55.xml,200,200,inclusion,139,1,183,198,161.0,99.5,44,197,0.2233502538071066
train,inclusion_56.xml,200,200,inclusion,9,1,51,180,30.0,90.5,42,179,0.2346368715083799
train,inclusion_56.xml,200,200,inclusion,51,1,79,198,65.0,99.5,28,197,0.14213197969543148
train,inclusion_57.xml,200,200,inclusion,145,94,178,176,161.5,135.0,33,82,0.4024390243902439
train,inclusion_57.xml,200,200,inclusion,99,104,123,168,111.0,136.0,24,64,0.375
train,inclusion_57.xml,200,200,inclusion,151,18,168,49,159.5,33.5,17,31,0.5483870967741935
train,inclusion_58.xml,200,200,inclusion,109,75,139,160,124.0,117.5,30,85,0.35294117647058826
train,inclusion_58.xml,200,200,inclusion,61,88,83,149,72.0,118.5,22,61,0.36065573770491804
train,inclusion_59.xml,200,200,inclusion,19,89,48,173,33.5,131.0,29,84,0.34523809523809523
train,inclusion_59.xml,200,200,inclusion,104,6,146,114,125.0,60.0,42,108,0.3888888888888889
train,inclusion_59.xml,200,200,inclusion,143,94,164,136,153.5,115.0,21,42,0.5
train,inclusion_59.xml,200,200,inclusion,24,16,40,50,32.0,33.0,16,34,0.47058823529411764
train,inclusion_6.xml,200,200,inclusion,167,83,200,95,183.5,89.0,33,12,2.75
train,inclusion_6.xml,200,200,inclusion,1,165,136,190,68.5,177.5,135,25,5.4
train,inclusion_6.xml,200,200,inclusion,147,167,174,183,160.5,175.0,27,16,1.6875
train,inclusion_60.xml,200,200,inclusion,32,1,55,68,43.5,34.5,23,67,0.34328358208955223
train,inclusion_60.xml,200,200,inclusion,30,151,48,200,39.0,175.5,18,49,0.3673469387755102
train,inclusion_60.xml,200,200,inclusion,132,81,174,198,153.0,139.5,42,117,0.358974358974359
train,inclusion_60.xml,200,200,inclusion,31,72,48,134,39.5,103.0,17,62,0.27419354838709675
train,inclusion_60.xml,200,200,inclusion,159,1,173,31,166.0,16.0,14,30,0.4666666666666667
train,inclusion_61.xml,200,200,inclusion,60,1,93,159,76.5,80.0,33,158,0.2088607594936709
train,inclusion_61.xml,200,200,inclusion,84,37,119,199,101.5,118.0,35,162,0.21604938271604937
train,inclusion_62.xml,200,200,inclusion,39,1,67,74,53.0,37.5,28,73,0.3835616438356164
train,inclusion_62.xml,200,200,inclusion,147,86,189,197,168.0,141.5,42,111,0.3783783783783784
train,inclusion_62.xml,200,200,inclusion,40,162,57,198,48.5,180.0,17,36,0.4722222222222222
train,inclusion_62.xml,200,200,inclusion,1,66,33,199,17.0,132.5,32,133,0.24060150375939848
train,inclusion_62.xml,200,200,inclusion,39,77,59,140,49.0,108.5,20,63,0.31746031746031744
train,inclusion_62.xml,200,200,inclusion,169,1,182,32,175.5,16.5,13,31,0.41935483870967744
train,inclusion_62.xml,200,200,inclusion,39,77,59,140,49.0,108.5,20,63,0.31746031746031744
train,inclusion_62.xml,200,200,inclusion,46,116,59,146,52.5,131.0,13,30,0.43333333333333335
train,inclusion_63.xml,200,200,inclusion,143,41,168,116,155.5,78.5,25,75,0.3333333333333333
train,inclusion_63.xml,200,200,inclusion,147,108,164,179,155.5,143.5,17,71,0.23943661971830985
train,inclusion_64.xml,200,200,inclusion,112,1,136,70,124.0,35.5,24,69,0.34782608695652173
train,inclusion_64.xml,200,200,inclusion,106,91,138,198,122.0,144.5,32,107,0.29906542056074764
train,inclusion_65.xml,200,200,inclusion,30,1,57,82,43.5,41.5,27,81,0.3333333333333333
train,inclusion_65.xml,200,200,inclusion,147,20,191,198,169.0,109.0,44,178,0.24719101123595505
train,inclusion_65.xml,200,200,inclusion,27,108,48,145,37.5,126.5,21,37,0.5675675675675675
train,inclusion_66.xml,200,200,inclusion,64,1,108,197,86.0,99.0,44,196,0.22448979591836735
train,inclusion_67.xml,200,200,inclusion,71,31,97,92,84.0,61.5,26,61,0.4262295081967213
train,inclusion_67.xml,200,200,inclusion,126,1,151,73,138.5,37.0,25,72,0.3472222222222222
train,inclusion_67.xml,200,200,inclusion,17,116,39,193,28.0,154.5,22,77,0.2857142857142857
train,inclusion_67.xml,200,200,inclusion,132,166,155,200,143.5,183.0,23,34,0.6764705882352942
train,inclusion_68.xml,200,200,inclusion,92,109,118,161,105.0,135.0,26,52,0.5
train,inclusion_68.xml,200,200,inclusion,154,6,171,66,162.5,36.0,17,60,0.2833333333333333
train,inclusion_69.xml,200,200,inclusion,30,30,52,98,41.0,64.0,22,68,0.3235294117647059
train,inclusion_69.xml,200,200,inclusion,37,116,56,167,46.5,141.5,19,51,0.37254901960784315
train,inclusion_69.xml,200,200,inclusion,141,71,165,146,153.0,108.5,24,75,0.32
train,inclusion_7.xml,200,200,inclusion,9,56,147,83,78.0,69.5,138,27,5.111111111111111
train,inclusion_7.xml,200,200,inclusion,151,61,183,75,167.0,68.0,32,14,2.2857142857142856
train,inclusion_70.xml,200,200,inclusion,87,46,117,116,102.0,81.0,30,70,0.42857142857142855
train,inclusion_70.xml,200,200,inclusion,86,127,106,179,96.0,153.0,20,52,0.38461538461538464
train,inclusion_70.xml,200,200,inclusion,24,5,73,179,48.5,92.0,49,174,0.28160919540229884
train,inclusion_71.xml,200,200,inclusion,76,73,114,158,95.0,115.5,38,85,0.4470588235294118
train,inclusion_71.xml,200,200,inclusion,110,66,136,112,123.0,89.0,26,46,0.5652173913043478
train,inclusion_72.xml,200,200,inclusion,92,40,125,113,108.5,76.5,33,73,0.4520547945205479
train,inclusion_73.xml,200,200,inclusion,75,1,108,129,91.5,65.0,33,128,0.2578125
train,inclusion_73.xml,200,200,inclusion,127,109,157,180,142.0,144.5,30,71,0.4225352112676056
train,inclusion_74.xml,200,200,inclusion,85,1,116,196,100.5,98.5,31,195,0.15897435897435896
train,inclusion_74.xml,200,200,inclusion,121,2,144,88,132.5,45.0,23,86,0.26744186046511625
train,inclusion_74.xml,200,200,inclusion,147,18,167,50,157.0,34.0,20,32,0.625
train,inclusion_75.xml,200,200,inclusion,7,2,40,197,23.5,99.5,33,195,0.16923076923076924
train,inclusion_75.xml,200,200,inclusion,43,76,67,164,55.0,120.0,24,88,0.2727272727272727
train,inclusion_75.xml,200,200,inclusion,115,23,133,78,124.0,50.5,18,55,0.32727272727272727
train,inclusion_75.xml,200,200,inclusion,69,97,89,127,79.0,112.0,20,30,0.6666666666666666
train,inclusion_76.xml,200,200,inclusion,80,1,128,198,104.0,99.5,48,197,0.2436548223350254
train,inclusion_76.xml,200,200,inclusion,130,115,155,194,142.5,154.5,25,79,0.31645569620253167
train,inclusion_76.xml,200,200,inclusion,158,135,174,164,166.0,149.5,16,29,0.5517241379310345
train,inclusion_77.xml,200,200,inclusion,77,69,123,198,100.0,133.5,46,129,0.35658914728682173
train,inclusion_78.xml,200,200,inclusion,107,1,141,75,124.0,38.0,34,74,0.4594594594594595
train,inclusion_78.xml,200,200,inclusion,99,139,131,199,115.0,169.0,32,60,0.5333333333333333
train,inclusion_78.xml,200,200,inclusion,2,49,29,99,15.5,74.0,27,50,0.54
train,inclusion_79.xml,200,200,inclusion,17,6,65,196,41.0,101.0,48,190,0.25263157894736843
train,inclusion_8.xml,200,200,inclusion,23,143,52,160,37.5,151.5,29,17,1.7058823529411764
train,inclusion_8.xml,200,200,inclusion,65,132,198,164,131.5,148.0,133,32,4.15625
train,inclusion_80.xml,200,200,inclusion,34,65,73,197,53.5,131.0,39,132,0.29545454545454547
train,inclusion_80.xml,200,200,inclusion,131,11,160,132,145.5,71.5,29,121,0.2396694214876033
train,inclusion_80.xml,200,200,inclusion,157,68,198,197,177.5,132.5,41,129,0.3178294573643411
train,inclusion_81.xml,200,200,inclusion,45,1,90,199,67.5,100.0,45,198,0.22727272727272727
train,inclusion_81.xml,200,200,inclusion,159,1,188,96,173.5,48.5,29,95,0.30526315789473685
train,inclusion_81.xml,200,200,inclusion,136,132,170,198,153.0,165.0,34,66,0.5151515151515151
train,inclusion_81.xml,200,200,inclusion,10,11,43,68,26.5,39.5,33,57,0.5789473684210527
train,inclusion_81.xml,200,200,inclusion,44,166,61,199,52.5,182.5,17,33,0.5151515151515151
train,inclusion_82.xml,200,200,inclusion,53,1,87,96,70.0,48.5,34,95,0.35789473684210527
train,inclusion_82.xml,200,200,inclusion,35,133,66,199,50.5,166.0,31,66,0.4696969696969697
train,inclusion_83.xml,200,200,inclusion,144,128,164,187,154.0,157.5,20,59,0.3389830508474576
train,inclusion_83.xml,200,200,inclusion,160,1,190,167,175.0,84.0,30,166,0.18072289156626506
train,inclusion_83.xml,200,200,inclusion,120,52,133,88,126.5,70.0,13,36,0.3611111111111111
train,inclusion_84.xml,200,200,inclusion,114,136,132,168,123.0,152.0,18,32,0.5625
train,inclusion_84.xml,200,200,inclusion,133,154,152,199,142.5,176.5,19,45,0.4222222222222222
train,inclusion_84.xml,200,200,inclusion,138,84,162,142,150.0,113.0,24,58,0.41379310344827586
train,inclusion_84.xml,200,200,inclusion,158,1,184,132,171.0,66.5,26,131,0.1984732824427481
train,inclusion_84.xml,200,200,inclusion,111,6,134,48,122.5,27.0,23,42,0.5476190476190477
train,inclusion_84.xml,200,200,inclusion,85,170,101,200,93.0,185.0,16,30,0.5333333333333333
train,inclusion_85.xml,200,200,inclusion,9,94,25,127,17.0,110.5,16,33,0.48484848484848486
train,inclusion_85.xml,200,200,inclusion,30,114,52,176,41.0,145.0,22,62,0.3548387096774194
train,inclusion_85.xml,200,200,inclusion,34,46,57,97,45.5,71.5,23,51,0.45098039215686275
train,inclusion_85.xml,200,200,inclusion,53,1,77,83,65.0,42.0,24,82,0.2926829268292683
train,inclusion_85.xml,200,200,inclusion,129,19,162,114,145.5,66.5,33,95,0.3473684210526316
train,inclusion_85.xml,200,200,inclusion,54,147,92,193,73.0,170.0,38,46,0.8260869565217391
train,inclusion_86.xml,200,200,inclusion,35,1,60,85,47.5,43.0,25,84,0.2976190476190476
train,inclusion_86.xml,200,200,inclusion,16,43,37,95,26.5,69.0,21,52,0.40384615384615385
train,inclusion_86.xml,200,200,inclusion,7,110,28,175,17.5,142.5,21,65,0.3230769230769231
train,inclusion_86.xml,200,200,inclusion,35,142,72,192,53.5,167.0,37,50,0.74
train,inclusion_86.xml,200,200,inclusion,110,21,144,110,127.0,65.5,34,89,0.38202247191011235
train,inclusion_87.xml,200,200,inclusion,45,83,67,119,56.0,101.0,22,36,0.6111111111111112
train,inclusion_87.xml,200,200,inclusion,67,102,90,165,78.5,133.5,23,63,0.36507936507936506
train,inclusion_87.xml,200,200,inclusion,92,139,134,181,113.0,160.0,42,42,1.0
train,inclusion_87.xml,200,200,inclusion,73,36,95,87,84.0,61.5,22,51,0.43137254901960786
train,inclusion_87.xml,200,200,inclusion,92,1,116,73,104.0,37.0,24,72,0.3333333333333333
train,inclusion_87.xml,200,200,inclusion,167,24,190,106,178.5,65.0,23,82,0.2804878048780488
train,inclusion_87.xml,200,200,inclusion,19,117,39,167,29.0,142.0,20,50,0.4
train,inclusion_88.xml,200,200,inclusion,61,27,79,75,70.0,51.0,18,48,0.375
train,inclusion_88.xml,200,200,inclusion,107,10,130,76,118.5,43.0,23,66,0.3484848484848485
train,inclusion_88.xml,200,200,inclusion,135,47,175,129,155.0,88.0,40,82,0.4878048780487805
train,inclusion_88.xml,200,200,inclusion,83,127,121,188,102.0,157.5,38,61,0.6229508196721312
train,inclusion_88.xml,200,200,inclusion,34,56,46,84,40.0,70.0,12,28,0.42857142857142855
train,inclusion_88.xml,200,200,inclusion,88,1,103,26,95.5,13.5,15,25,0.6
train,inclusion_88.xml,200,200,inclusion,36,88,47,110,41.5,99.0,11,22,0.5
train,inclusion_88.xml,200,200,inclusion,37,142,49,170,43.0,156.0,12,28,0.42857142857142855
train,inclusion_89.xml,200,200,inclusion,75,58,115,123,95.0,90.5,40,65,0.6153846153846154
train,inclusion_89.xml,200,200,inclusion,126,1,157,98,141.5,49.5,31,97,0.31958762886597936
train,inclusion_89.xml,200,200,inclusion,166,137,188,177,177.0,157.0,22,40,0.55
train,inclusion_89.xml,200,200,inclusion,28,21,42,46,35.0,33.5,14,25,0.56
train,inclusion_89.xml,200,200,inclusion,28,74,43,104,35.5,89.0,15,30,0.5
train,inclusion_9.xml,200,200,inclusion,1,64,122,93,61.5,78.5,121,29,4.172413793103448
train,inclusion_90.xml,200,200,inclusion,35,1,72,91,53.5,46.0,37,90,0.4111111111111111
train,inclusion_91.xml,200,200,inclusion,69,44,108,114,88.5,79.0,39,70,0.5571428571428572
train,inclusion_91.xml,200,200,inclusion,42,8,65,74,53.5,41.0,23,66,0.3484848484848485
train,inclusion_91.xml,200,200,inclusion,28,119,58,186,43.0,152.5,30,67,0.44776119402985076
train,inclusion_91.xml,200,200,inclusion,25,1,36,24,30.5,12.5,11,23,0.4782608695652174
train,inclusion_92.xml,200,200,inclusion,120,58,154,180,137.0,119.0,34,122,0.2786885245901639
train,inclusion_92.xml,200,200,inclusion,148,45,170,84,159.0,64.5,22,39,0.5641025641025641
train,inclusion_92.xml,200,200,inclusion,29,32,61,77,45.0,54.5,32,45,0.7111111111111111
train,inclusion_92.xml,200,200,inclusion,79,1,96,37,87.5,19.0,17,36,0.4722222222222222
train,inclusion_93.xml,200,200,inclusion,42,57,76,133,59.0,95.0,34,76,0.4473684210526316
train,inclusion_93.xml,200,200,inclusion,85,89,115,184,100.0,136.5,30,95,0.3157894736842105
train,inclusion_93.xml,200,200,inclusion,150,95,175,182,162.5,138.5,25,87,0.28735632183908044
train,inclusion_93.xml,200,200,inclusion,154,25,179,85,166.5,55.0,25,60,0.4166666666666667
train,inclusion_93.xml,200,200,inclusion,42,22,60,60,51.0,41.0,18,38,0.47368421052631576
train,inclusion_94.xml,200,200,inclusion,8,2,38,93,23.0,47.5,30,91,0.32967032967032966
train,inclusion_94.xml,200,200,inclusion,69,9,99,88,84.0,48.5,30,79,0.379746835443038
train,inclusion_94.xml,200,200,inclusion,18,110,43,198,30.5,154.0,25,88,0.2840909090909091
train,inclusion_94.xml,200,200,inclusion,115,119,146,184,130.5,151.5,31,65,0.47692307692307695
train,inclusion_94.xml,200,200,inclusion,136,43,159,101,147.5,72.0,23,58,0.39655172413793105
train,inclusion_94.xml,200,200,inclusion,105,30,128,55,116.5,42.5,23,25,0.92
train,inclusion_95.xml,200,200,inclusion,37,4,67,131,52.0,67.5,30,127,0.23622047244094488
train,inclusion_95.xml,200,200,inclusion,139,9,175,72,157.0,40.5,36,63,0.5714285714285714
train,inclusion_95.xml,200,200,inclusion,136,84,160,147,148.0,115.5,24,63,0.38095238095238093
train,inclusion_96.xml,200,200,inclusion,119,57,156,160,137.5,108.5,37,103,0.3592233009708738
train,inclusion_96.xml,200,200,inclusion,30,58,55,109,42.5,83.5,25,51,0.49019607843137253
train,inclusion_96.xml,200,200,inclusion,32,144,60,199,46.0,171.5,28,55,0.509090909090909
train,inclusion_97.xml,200,200,inclusion,150,26,188,154,169.0,90.0,38,128,0.296875
train,inclusion_98.xml,200,200,inclusion,38,1,109,198,73.5,99.5,71,197,0.3604060913705584
train,inclusion_99.xml,200,200,inclusion,109,3,180,198,144.5,100.5,71,195,0.3641025641025641
train,patches_1.xml,200,200,patches,43,10,106,97,74.5,53.5,63,87,0.7241379310344828
train,patches_1.xml,200,200,patches,32,91,81,148,56.5,119.5,49,57,0.8596491228070176
train,patches_1.xml,200,200,patches,23,156,62,198,42.5,177.0,39,42,0.9285714285714286
train,patches_10.xml,200,200,patches,9,88,49,140,29.0,114.0,40,52,0.7692307692307693
train,patches_10.xml,200,200,patches,124,1,173,117,148.5,59.0,49,116,0.4224137931034483
train,patches_100.xml,200,200,patches,1,73,21,132,11.0,102.5,20,59,0.3389830508474576
train,patches_100.xml,200,200,patches,109,1,160,111,134.5,56.0,51,110,0.4636363636363636
train,patches_100.xml,200,200,patches,120,117,163,186,141.5,151.5,43,69,0.6231884057971014
train,patches_101.xml,200,200,patches,27,1,78,92,52.5,46.5,51,91,0.5604395604395604
train,patches_101.xml,200,200,patches,113,1,175,59,144.0,30.0,62,58,1.0689655172413792
train,patches_101.xml,200,200,patches,129,79,176,200,152.5,139.5,47,121,0.3884297520661157
train,patches_102.xml,200,200,patches,20,53,94,139,57.0,96.0,74,86,0.8604651162790697
train,patches_102.xml,200,200,patches,126,108,166,156,146.0,132.0,40,48,0.8333333333333334
train,patches_103.xml,200,200,patches,64,30,117,181,90.5,105.5,53,151,0.3509933774834437
train,patches_104.xml,200,200,patches,1,88,41,200,21.0,144.0,40,112,0.35714285714285715
train,patches_104.xml,200,200,patches,50,107,84,157,67.0,132.0,34,50,0.68
train,patches_104.xml,200,200,patches,129,26,168,94,148.5,60.0,39,68,0.5735294117647058
train,patches_104.xml,200,200,patches,152,140,199,200,175.5,170.0,47,60,0.7833333333333333
train,patches_105.xml,200,200,patches,29,1,76,92,52.5,46.5,47,91,0.5164835164835165
train,patches_105.xml,200,200,patches,116,1,174,53,145.0,27.0,58,52,1.1153846153846154
train,patches_105.xml,200,200,patches,130,78,173,200,151.5,139.0,43,122,0.3524590163934426
train,patches_106.xml,200,200,patches,75,67,108,139,91.5,103.0,33,72,0.4583333333333333
train,patches_107.xml,200,200,patches,97,9,152,111,124.5,60.0,55,102,0.5392156862745098
train,patches_107.xml,200,200,patches,69,1,103,14,86.0,7.5,34,13,2.6153846153846154
train,patches_108.xml,200,200,patches,8,1,64,122,36.0,61.5,56,121,0.4628099173553719
train,patches_108.xml,200,200,patches,75,1,177,111,126.0,56.0,102,110,0.9272727272727272
train,patches_108.xml,200,200,patches,145,117,190,187,167.5,152.0,45,70,0.6428571428571429
train,patches_109.xml,200,200,patches,1,124,23,153,12.0,138.5,22,29,0.7586206896551724
train,patches_109.xml,200,200,patches,67,20,130,170,98.5,95.0,63,150,0.42
train,patches_109.xml,200,200,patches,176,116,200,157,188.0,136.5,24,41,0.5853658536585366
train,patches_11.xml,200,200,patches,1,65,50,164,25.5,114.5,49,99,0.494949494949495
train,patches_11.xml,200,200,patches,158,65,192,168,175.0,116.5,34,103,0.3300970873786408
train,patches_110.xml,200,200,patches,11,94,47,137,29.0,115.5,36,43,0.8372093023255814
train,patches_110.xml,200,200,patches,61,68,140,165,100.5,116.5,79,97,0.8144329896907216
train,patches_111.xml,200,200,patches,53,147,102,199,77.5,173.0,49,52,0.9423076923076923
train,patches_111.xml,200,200,patches,132,1,195,178,163.5,89.5,63,177,0.3559322033898305
train,patches_112.xml,200,200,patches,48,136,96,174,72.0,155.0,48,38,1.263157894736842
train,patches_112.xml,200,200,patches,58,9,100,77,79.0,43.0,42,68,0.6176470588235294
train,patches_112.xml,200,200,patches,132,24,181,76,156.5,50.0,49,52,0.9423076923076923
train,patches_112.xml,200,200,patches,132,80,200,199,166.0,139.5,68,119,0.5714285714285714
train,patches_113.xml,200,200,patches,4,71,78,167,41.0,119.0,74,96,0.7708333333333334
train,patches_113.xml,200,200,patches,135,39,181,76,158.0,57.5,46,37,1.2432432432432432
train,patches_114.xml,200,200,patches,1,1,88,113,44.5,57.0,87,112,0.7767857142857143
train,patches_114.xml,200,200,patches,58,120,102,189,80.0,154.5,44,69,0.6376811594202898
train,patches_114.xml,200,200,patches,131,125,182,198,156.5,161.5,51,73,0.6986301369863014
train,patches_114.xml,200,200,patches,130,28,178,98,154.0,63.0,48,70,0.6857142857142857
train,patches_114.xml,200,200,patches,148,1,192,29,170.0,15.0,44,28,1.5714285714285714
train,patches_115.xml,200,200,patches,16,93,92,200,54.0,146.5,76,107,0.7102803738317757
train,patches_115.xml,200,200,patches,111,127,161,179,136.0,153.0,50,52,0.9615384615384616
train,patches_115.xml,200,200,patches,56,6,92,62,74.0,34.0,36,56,0.6428571428571429
train,patches_115.xml,200,200,patches,147,41,198,133,172.5,87.0,51,92,0.5543478260869565
train,patches_116.xml,200,200,patches,27,4,92,200,59.5,102.0,65,196,0.33163265306122447
train,patches_116.xml,200,200,patches,114,62,196,200,155.0,131.0,82,138,0.5942028985507246
train,patches_116.xml,200,200,patches,163,1,194,29,178.5,15.0,31,28,1.1071428571428572
train,patches_117.xml,200,200,patches,1,68,51,123,26.0,95.5,50,55,0.9090909090909091
train,patches_117.xml,200,200,patches,82,83,155,160,118.5,121.5,73,77,0.948051948051948
train,patches_118.xml,200,200,patches,6,18,90,91,48.0,54.5,84,73,1.1506849315068493
train,patches_118.xml,200,200,patches,129,10,198,200,163.5,105.0,69,190,0.3631578947368421
train,patches_118.xml,200,200,patches,87,68,172,199,129.5,133.5,85,131,0.648854961832061
train,patches_119.xml,200,200,patches,1,2,80,199,40.5,100.5,79,197,0.4010152284263959
train,patches_119.xml,200,200,patches,148,1,186,43,167.0,22.0,38,42,0.9047619047619048
train,patches_119.xml,200,200,patches,104,89,200,199,152.0,144.0,96,110,0.8727272727272727
train,patches_12.xml,200,200,patches,15,154,46,200,30.5,177.0,31,46,0.6739130434782609
train,patches_12.xml,200,200,patches,89,78,166,166,127.5,122.0,77,88,0.875
train,patches_12.xml,200,200,patches,125,14,164,63,144.5,38.5,39,49,0.7959183673469388
train,patches_120.xml,200,200,patches,41,1,83,73,62.0,37.0,42,72,0.5833333333333334
train,patches_120.xml,200,200,patches,105,1,183,86,144.0,43.5,78,85,0.9176470588235294
train,patches_120.xml,200,200,patches,34,91,83,200,58.5,145.5,49,109,0.44954128440366975
train,patches_120.xml,200,200,patches,85,70,147,200,116.0,135.0,62,130,0.47692307692307695
train,patches_120.xml,200,200,patches,1,154,22,198,11.5,176.0,21,44,0.4772727272727273
train,patches_121.xml,200,200,patches,135,1,192,193,163.5,97.0,57,192,0.296875
train,patches_122.xml,200,200,patches,14,1,54,29,34.0,15.0,40,28,1.4285714285714286
train,patches_122.xml,200,200,patches,68,30,106,63,87.0,46.5,38,33,1.1515151515151516
train,patches_122.xml,200,200,patches,112,3,158,72,135.0,37.5,46,69,0.6666666666666666
train,patches_122.xml,200,200,patches,72,75,156,176,114.0,125.5,84,101,0.8316831683168316
train,patches_123.xml,200,200,patches,56,16,144,198,100.0,107.0,88,182,0.4835164835164835
train,patches_123.xml,200,200,patches,152,146,190,198,171.0,172.0,38,52,0.7307692307692307
train,patches_124.xml,200,200,patches,3,1,86,178,44.5,89.5,83,177,0.4689265536723164
train,patches_124.xml,200,200,patches,96,28,194,167,145.0,97.5,98,139,0.7050359712230215
train,patches_125.xml,200,200,patches,1,160,33,200,17.0,180.0,32,40,0.8
train,patches_125.xml,200,200,patches,128,1,184,111,156.0,56.0,56,110,0.509090909090909
train,patches_126.xml,200,200,patches,66,24,121,166,93.5,95.0,55,142,0.3873239436619718
train,patches_127.xml,200,200,patches,1,170,44,199,22.5,184.5,43,29,1.4827586206896552
train,patches_127.xml,200,200,patches,1,1,160,129,80.5,65.0,159,128,1.2421875
train,patches_127.xml,200,200,patches,148,122,188,197,168.0,159.5,40,75,0.5333333333333333
train,patches_127.xml,200,200,patches,144,1,192,130,168.0,65.5,48,129,0.37209302325581395
train,patches_128.xml,200,200,patches,1,42,52,184,26.5,113.0,51,142,0.3591549295774648
train,patches_128.xml,200,200,patches,148,61,190,109,169.0,85.0,42,48,0.875
train,patches_128.xml,200,200,patches,146,1,190,59,168.0,30.0,44,58,0.7586206896551724
train,patches_128.xml,200,200,patches,169,179,200,199,184.5,189.0,31,20,1.55
train,patches_128.xml,200,200,patches,1,1,28,16,14.5,8.5,27,15,1.8
train,patches_129.xml,200,200,patches,38,34,69,109,53.5,71.5,31,75,0.41333333333333333
train,patches_13.xml,200,200,patches,64,69,116,178,90.0,123.5,52,109,0.47706422018348627
train,patches_130.xml,200,200,patches,21,17,64,189,42.5,103.0,43,172,0.25
train,patches_130.xml,200,200,patches,116,87,192,199,154.0,143.0,76,112,0.6785714285714286
train,patches_130.xml,200,200,patches,161,1,187,16,174.0,8.5,26,15,1.7333333333333334
train,patches_131.xml,200,200,patches,23,154,45,176,34.0,165.0,22,22,1.0
train,patches_131.xml,200,200,patches,57,73,82,105,69.5,89.0,25,32,0.78125
train,patches_131.xml,200,200,patches,67,120,144,200,105.5,160.0,77,80,0.9625
train,patches_132.xml,200,200,patches,16,1,59,111,37.5,56.0,43,110,0.39090909090909093
train,patches_132.xml,200,200,patches,109,14,189,191,149.0,102.5,80,177,0.4519774011299435
train,patches_133.xml,200,200,patches,58,1,130,38,94.0,19.5,72,37,1.945945945945946
train,patches_133.xml,200,200,patches,103,35,136,94,119.5,64.5,33,59,0.559322033898305
train,patches_133.xml,200,200,patches,64,172,131,199,97.5,185.5,67,27,2.4814814814814814
train,patches_134.xml,200,200,patches,53,36,124,174,88.5,105.0,71,138,0.5144927536231884
train,patches_134.xml,200,200,patches,155,118,200,194,177.5,156.0,45,76,0.5921052631578947
train,patches_135.xml,200,200,patches,73,27,110,94,91.5,60.5,37,67,0.5522388059701493
train,patches_136.xml,200,200,patches,76,1,132,199,104.0,100.0,56,198,0.2828282828282828
train,patches_137.xml,200,200,patches,21,48,101,123,61.0,85.5,80,75,1.0666666666666667
train,patches_137.xml,200,200,patches,99,51,179,190,139.0,120.5,80,139,0.5755395683453237
train,patches_138.xml,200,200,patches,24,99,109,199,66.5,149.0,85,100,0.85
train,patches_138.xml,200,200,patches,64,1,133,89,98.5,45.0,69,88,0.7840909090909091
train,patches_138.xml,200,200,patches,1,1,43,22,22.0,11.5,42,21,2.0
train,patches_139.xml,200,200,patches,40,85,107,188,73.5,136.5,67,103,0.6504854368932039
train,patches_139.xml,200,200,patches,135,124,190,179,162.5,151.5,55,55,1.0
train,patches_139.xml,200,200,patches,62,11,87,55,74.5,33.0,25,44,0.5681818181818182
train,patches_14.xml,200,200,patches,78,71,150,127,114.0,99.0,72,56,1.2857142857142858
train,patches_140.xml,200,200,patches,5,1,70,56,37.5,28.5,65,55,1.1818181818181819
train,patches_140.xml,200,200,patches,20,118,65,192,42.5,155.0,45,74,0.6081081081081081
train,patches_140.xml,200,200,patches,82,127,141,193,111.5,160.0,59,66,0.8939393939393939
train,patches_140.xml,200,200,patches,98,1,154,42,126.0,21.5,56,41,1.3658536585365855
train,patches_140.xml,200,200,patches,154,10,200,199,177.0,104.5,46,189,0.24338624338624337
train,patches_141.xml,200,200,patches,71,104,98,130,84.5,117.0,27,26,1.0384615384615385
train,patches_141.xml,200,200,patches,131,14,179,90,155.0,52.0,48,76,0.631578947368421
train,patches_141.xml,200,200,patches,129,106,190,200,159.5,153.0,61,94,0.648936170212766
train,patches_142.xml,200,200,patches,1,13,47,88,24.0,50.5,46,75,0.6133333333333333
train,patches_142.xml,200,200,patches,1,106,60,199,30.5,152.5,59,93,0.6344086021505376
train,patches_142.xml,200,200,patches,63,26,128,107,95.5,66.5,65,81,0.8024691358024691
train,patches_142.xml,200,200,patches,130,1,197,161,163.5,81.0,67,160,0.41875
train,patches_142.xml,200,200,patches,100,127,179,199,139.5,163.0,79,72,1.0972222222222223
train,patches_143.xml,200,200,patches,35,6,125,163,80.0,84.5,90,157,0.5732484076433121
train,patches_143.xml,200,200,patches,1,20,30,54,15.5,37.0,29,34,0.8529411764705882
train,patches_143.xml,200,200,patches,39,173,80,200,59.5,186.5,41,27,1.5185185185185186
train,patches_144.xml,200,200,patches,17,47,74,139,45.5,93.0,57,92,0.6195652173913043
train,patches_144.xml,200,200,patches,80,10,167,118,123.5,64.0,87,108,0.8055555555555556
train,patches_145.xml,200,200,patches,6,1,76,67,41.0,34.0,70,66,1.0606060606060606
train,patches_145.xml,200,200,patches,4,76,65,200,34.5,138.0,61,124,0.49193548387096775
train,patches_145.xml,200,200,patches,109,1,174,80,141.5,40.5,65,79,0.8227848101265823
train,patches_145.xml,200,200,patches,113,69,190,199,151.5,134.0,77,130,0.5923076923076923
train,patches_146.xml,200,200,patches,1,1,66,79,33.5,40.0,65,78,0.8333333333333334
train,patches_146.xml,200,200,patches,6,68,74,200,40.0,134.0,68,132,0.5151515151515151
train,patches_146.xml,200,200,patches,139,1,178,48,158.5,24.5,39,47,0.8297872340425532
train,patches_147.xml,200,200,patches,40,1,88,76,64.0,38.5,48,75,0.64
train,patches_147.xml,200,200,patches,43,88,103,199,73.0,143.5,60,111,0.5405405405405406
train,patches_147.xml,200,200,patches,161,1,200,199,180.5,100.0,39,198,0.19696969696969696
train,patches_148.xml,200,200,patches,1,42,41,146,21.0,94.0,40,104,0.38461538461538464
train,patches_148.xml,200,200,patches,62,1,144,189,103.0,95.0,82,188,0.43617021276595747
train,patches_149.xml,200,200,patches,38,3,136,194,87.0,98.5,98,191,0.5130890052356021
train,patches_149.xml,200,200,patches,137,47,199,199,168.0,123.0,62,152,0.40789473684210525
train,patches_149.xml,200,200,patches,155,1,198,56,176.5,28.5,43,55,0.7818181818181819
train,patches_15.xml,200,200,patches,59,1,112,52,85.5,26.5,53,51,1.0392156862745099
train,patches_15.xml,200,200,patches,67,75,109,200,88.0,137.5,42,125,0.336
train,patches_150.xml,200,200,patches,3,1,59,157,31.0,79.0,56,156,0.358974358974359
train,patches_150.xml,200,200,patches,1,161,51,200,26.0,180.5,50,39,1.2820512820512822
train,patches_150.xml,200,200,patches,118,1,194,200,156.0,100.5,76,199,0.38190954773869346
train,patches_151.xml,200,200,patches,27,1,87,196,57.0,98.5,60,195,0.3076923076923077
train,patches_151.xml,200,200,patches,1,1,27,91,14.0,46.0,26,90,0.28888888888888886
train,patches_151.xml,200,200,patches,78,103,127,188,102.5,145.5,49,85,0.5764705882352941
train,patches_151.xml,200,200,patches,150,1,200,200,175.0,100.5,50,199,0.25125628140703515
train,patches_152.xml,200,200,patches,19,1,73,79,46.0,40.0,54,78,0.6923076923076923
train,patches_152.xml,200,200,patches,7,103,32,149,19.5,126.0,25,46,0.5434782608695652
train,patches_152.xml,200,200,patches,95,157,132,200,113.5,178.5,37,43,0.8604651162790697
train,patches_152.xml,200,200,patches,152,149,200,200,176.0,174.5,48,51,0.9411764705882353
train,patches_152.xml,200,200,patches,96,1,142,110,119.0,55.5,46,109,0.42201834862385323
train,patches_152.xml,200,200,patches,144,21,195,104,169.5,62.5,51,83,0.6144578313253012
train,patches_153.xml,200,200,patches,27,53,132,157,79.5,105.0,105,104,1.0096153846153846
train,patches_154.xml,200,200,patches,28,1,73,63,50.5,32.0,45,62,0.7258064516129032
train,patches_154.xml,200,200,patches,41,78,74,140,57.5,109.0,33,62,0.532258064516129
train,patches_154.xml,200,200,patches,133,85,156,118,144.5,101.5,23,33,0.696969696969697
train,patches_155.xml,200,200,patches,1,1,60,156,30.5,78.5,59,155,0.38064516129032255
train,patches_155.xml,200,200,patches,62,1,116,25,89.0,13.0,54,24,2.25
train,patches_155.xml,200,200,patches,134,1,193,99,163.5,50.0,59,98,0.6020408163265306
train,patches_155.xml,200,200,patches,131,136,177,200,154.0,168.0,46,64,0.71875
train,patches_155.xml,200,200,inclusion,75,42,130,120,102.5,81.0,55,78,0.7051282051282052
train,patches_155.xml,200,200,inclusion,154,108,182,143,168.0,125.5,28,35,0.8
train,patches_156.xml,200,200,patches,94,61,127,86,110.5,73.5,33,25,1.32
train,patches_156.xml,200,200,patches,92,105,129,189,110.5,147.0,37,84,0.44047619047619047
train,patches_157.xml,200,200,patches,50,1,148,190,99.0,95.5,98,189,0.5185185185185185
train,patches_157.xml,200,200,patches,1,1,37,106,19.0,53.5,36,105,0.34285714285714286
train,patches_158.xml,200,200,patches,7,1,87,198,47.0,99.5,80,197,0.40609137055837563
train,patches_158.xml,200,200,patches,103,1,190,198,146.5,99.5,87,197,0.4416243654822335
train,patches_159.xml,200,200,patches,116,14,158,70,137.0,42.0,42,56,0.75
train,patches_159.xml,200,200,patches,113,142,154,199,133.5,170.5,41,57,0.7192982456140351
train,patches_16.xml,200,200,patches,2,45,43,200,22.5,122.5,41,155,0.2645161290322581
train,patches_16.xml,200,200,patches,135,149,176,200,155.5,174.5,41,51,0.803921568627451
train,patches_16.xml,200,200,patches,1,1,50,56,25.5,28.5,49,55,0.8909090909090909
train,patches_160.xml,200,200,patches,122,139,169,200,145.5,169.5,47,61,0.7704918032786885
train,patches_161.xml,200,200,patches,66,1,150,75,108.0,38.0,84,74,1.135135135135135
train,patches_162.xml,200,200,patches,22,109,101,196,61.5,152.5,79,87,0.9080459770114943
train,patches_163.xml,200,200,patches,104,1,148,42,126.0,21.5,44,41,1.0731707317073171
train,patches_163.xml,200,200,patches,1,1,67,25,34.0,13.0,66,24,2.75
train,patches_164.xml,200,200,patches,102,45,180,163,141.0,104.0,78,118,0.6610169491525424
train,patches_165.xml,200,200,patches,44,73,106,197,75.0,135.0,62,124,0.5
train,patches_165.xml,200,200,patches,183,14,200,92,191.5,53.0,17,78,0.21794871794871795
train,patches_165.xml,200,200,patches,1,155,22,200,11.5,177.5,21,45,0.4666666666666667
train,patches_165.xml,200,200,patches,165,155,199,200,182.0,177.5,34,45,0.7555555555555555
train,patches_166.xml,200,200,patches,34,4,74,86,54.0,45.0,40,82,0.4878048780487805
train,patches_166.xml,200,200,patches,101,17,179,170,140.0,93.5,78,153,0.5098039215686274
train,patches_166.xml,200,200,patches,25,159,55,199,40.0,179.0,30,40,0.75
train,patches_167.xml,200,200,patches,39,1,102,132,70.5,66.5,63,131,0.48091603053435117
train,patches_167.xml,200,200,patches,108,1,165,115,136.5,58.0,57,114,0.5
train,patches_167.xml,200,200,patches,168,1,200,85,184.0,43.0,32,84,0.38095238095238093
train,patches_167.xml,200,200,inclusion,176,154,200,180,188.0,167.0,24,26,0.9230769230769231
train,patches_167.xml,200,200,inclusion,149,126,170,145,159.5,135.5,21,19,1.105263157894737
train,patches_168.xml,200,200,patches,34,75,78,177,56.0,126.0,44,102,0.43137254901960786
train,patches_168.xml,200,200,patches,121,90,178,156,149.5,123.0,57,66,0.8636363636363636
train,patches_168.xml,200,200,patches,133,1,200,62,166.5,31.5,67,61,1.098360655737705
train,patches_168.xml,200,200,inclusion,1,108,30,149,15.5,128.5,29,41,0.7073170731707317
train,patches_168.xml,200,200,inclusion,79,54,104,74,91.5,64.0,25,20,1.25
train,patches_168.xml,200,200,inclusion,149,138,196,169,172.5,153.5,47,31,1.5161290322580645
train,patches_168.xml,200,200,inclusion,161,78,200,112,180.5,95.0,39,34,1.1470588235294117
train,patches_169.xml,200,200,patches,17,9,93,149,55.0,79.0,76,140,0.5428571428571428
train,patches_169.xml,200,200,patches,100,33,158,199,129.0,116.0,58,166,0.3493975903614458
train,patches_17.xml,200,200,patches,22,13,69,198,45.5,105.5,47,185,0.25405405405405407
train,patches_17.xml,200,200,patches,113,1,182,128,147.5,64.5,69,127,0.5433070866141733
train,patches_17.xml,200,200,patches,106,134,183,199,144.5,166.5,77,65,1.1846153846153846
train,patches_170.xml,200,200,patches,54,1,140,96,97.0,48.5,86,95,0.9052631578947369
train,patches_171.xml,200,200,patches,1,54,62,90,31.5,72.0,61,36,1.6944444444444444
train,patches_171.xml,200,200,patches,94,1,170,75,132.0,38.0,76,74,1.027027027027027
train,patches_171.xml,200,200,patches,74,109,184,199,129.0,154.0,110,90,1.2222222222222223
train,patches_171.xml,200,200,inclusion,144,93,175,119,159.5,106.0,31,26,1.1923076923076923
train,patches_171.xml,200,200,inclusion,156,47,198,75,177.0,61.0,42,28,1.5
train,patches_172.xml,200,200,patches,21,23,75,146,48.0,84.5,54,123,0.43902439024390244
train,patches_172.xml,200,200,patches,16,163,71,200,43.5,181.5,55,37,1.4864864864864864
train,patches_172.xml,200,200,patches,105,87,166,155,135.5,121.0,61,68,0.8970588235294118
train,patches_172.xml,200,200,patches,164,65,200,149,182.0,107.0,36,84,0.42857142857142855
train,patches_172.xml,200,200,inclusion,171,1,196,21,183.5,11.0,25,20,1.25
train,patches_172.xml,200,200,inclusion,160,150,200,184,180.0,167.0,40,34,1.1764705882352942
train,patches_173.xml,200,200,patches,20,55,84,173,52.0,114.0,64,118,0.5423728813559322
train,patches_174.xml,200,200,patches,11,1,68,200,39.5,100.5,57,199,0.2864321608040201
train,patches_174.xml,200,200,patches,132,1,200,200,166.0,100.5,68,199,0.3417085427135678
train,patches_174.xml,200,200,inclusion,1,122,21,178,11.0,150.0,20,56,0.35714285714285715
train,patches_174.xml,200,200,inclusion,102,88,125,111,113.5,99.5,23,23,1.0
train,patches_175.xml,200,200,patches,10,12,117,110,63.5,61.0,107,98,1.0918367346938775
train,patches_175.xml,200,200,patches,1,116,53,200,27.0,158.0,52,84,0.6190476190476191
train,patches_175.xml,200,200,patches,129,1,193,200,161.0,100.5,64,199,0.32160804020100503
train,patches_175.xml,200,200,inclusion,74,7,112,27,93.0,17.0,38,20,1.9
train,patches_175.xml,200,200,inclusion,97,143,138,199,117.5,171.0,41,56,0.7321428571428571
train,patches_176.xml,200,200,patches,20,1,80,198,50.0,99.5,60,197,0.30456852791878175
train,patches_176.xml,200,200,patches,149,1,199,53,174.0,27.0,50,52,0.9615384615384616
train,patches_176.xml,200,200,inclusion,2,17,23,40,12.5,28.5,21,23,0.9130434782608695
train,patches_176.xml,200,200,inclusion,1,107,24,172,12.5,139.5,23,65,0.35384615384615387
train,patches_176.xml,200,200,inclusion,162,4,182,22,172.0,13.0,20,18,1.1111111111111112
train,patches_177.xml,200,200,patches,49,46,135,175,92.0,110.5,86,129,0.6666666666666666
train,patches_177.xml,200,200,patches,139,60,199,182,169.0,121.0,60,122,0.4918032786885246
train,patches_177.xml,200,200,patches,141,1,182,48,161.5,24.5,41,47,0.8723404255319149
train,patches_178.xml,200,200,patches,61,6,140,162,100.5,84.0,79,156,0.5064102564102564
train,patches_179.xml,200,200,patches,89,1,137,59,113.0,30.0,48,58,0.8275862068965517
train,patches_179.xml,200,200,patches,14,101,132,193,73.0,147.0,118,92,1.2826086956521738
train,patches_179.xml,200,200,inclusion,50,165,82,192,66.0,178.5,32,27,1.1851851851851851
train,patches_179.xml,200,200,inclusion,57,23,92,53,74.5,38.0,35,30,1.1666666666666667
train,patches_18.xml,200,200,patches,42,1,108,78,75.0,39.5,66,77,0.8571428571428571
train,patches_18.xml,200,200,patches,116,47,183,108,149.5,77.5,67,61,1.098360655737705
train,patches_18.xml,200,200,patches,50,116,97,200,73.5,158.0,47,84,0.5595238095238095
train,patches_180.xml,200,200,patches,1,52,34,118,17.5,85.0,33,66,0.5
train,patches_180.xml,200,200,patches,62,13,109,131,85.5,72.0,47,118,0.3983050847457627
train,patches_180.xml,200,200,patches,112,1,154,48,133.0,24.5,42,47,0.8936170212765957
train,patches_181.xml,200,200,patches,4,5,87,73,45.5,39.0,83,68,1.2205882352941178
train,patches_181.xml,200,200,patches,102,86,156,165,129.0,125.5,54,79,0.6835443037974683
train,patches_181.xml,200,200,patches,126,10,200,76,163.0,43.0,74,66,1.121212121212121
train,patches_181.xml,200,200,patches,54,156,95,198,74.5,177.0,41,42,0.9761904761904762
train,patches_182.xml,200,200,patches,50,16,136,139,93.0,77.5,86,123,0.6991869918699187
train,patches_183.xml,200,200,patches,42,32,121,199,81.5,115.5,79,167,0.47305389221556887
train,patches_183.xml,200,200,patches,125,1,199,133,162.0,67.0,74,132,0.5606060606060606
train,patches_184.xml,200,200,patches,34,96,137,186,85.5,141.0,103,90,1.1444444444444444
train,patches_184.xml,200,200,patches,89,1,126,51,107.5,26.0,37,50,0.74
train,patches_184.xml,200,200,patches,161,1,200,21,180.5,11.0,39,20,1.95
train,patches_184.xml,200,200,inclusion,84,62,110,99,97.0,80.5,26,37,0.7027027027027027
train,patches_184.xml,200,200,inclusion,92,185,121,200,106.5,192.5,29,15,1.9333333333333333
train,patches_184.xml,200,200,patches,1,97,28,152,14.5,124.5,27,55,0.4909090909090909
train,patches_185.xml,200,200,patches,52,1,122,168,87.0,84.5,70,167,0.41916167664670656
train,patches_186.xml,200,200,patches,37,1,102,131,69.5,66.0,65,130,0.5
train,patches_186.xml,200,200,patches,122,56,200,159,161.0,107.5,78,103,0.7572815533980582
train,patches_186.xml,200,200,patches,57,140,119,198,88.0,169.0,62,58,1.0689655172413792
train,patches_187.xml,200,200,patches,59,1,117,114,88.0,57.5,58,113,0.5132743362831859
train,patches_187.xml,200,200,patches,1,62,55,133,28.0,97.5,54,71,0.7605633802816901
train,patches_187.xml,200,200,patches,64,155,112,200,88.0,177.5,48,45,1.0666666666666667
train,patches_187.xml,200,200,inclusion,32,109,53,136,42.5,122.5,21,27,0.7777777777777778
train,patches_187.xml,200,200,inclusion,46,156,64,179,55.0,167.5,18,23,0.782608695652174
train,patches_187.xml,200,200,inclusion,165,35,190,64,177.5,49.5,25,29,0.8620689655172413
train,patches_187.xml,200,200,inclusion,175,91,190,113,182.5,102.0,15,22,0.6818181818181818
train,patches_188.xml,200,200,patches,1,1,61,106,31.0,53.5,60,105,0.5714285714285714
train,patches_188.xml,200,200,patches,1,130,52,199,26.5,164.5,51,69,0.7391304347826086
train,patches_188.xml,200,200,patches,138,1,200,181,169.0,91.0,62,180,0.34444444444444444
train,patches_188.xml,200,200,inclusion,1,19,25,39,13.0,29.0,24,20,1.2
train,patches_188.xml,200,200,inclusion,112,91,136,124,124.0,107.5,24,33,0.7272727272727273
train,patches_189.xml,200,200,patches,64,98,115,166,89.5,132.0,51,68,0.75
train,patches_189.xml,200,200,patches,55,1,107,75,81.0,38.0,52,74,0.7027027027027027
train,patches_189.xml,200,200,patches,108,40,161,71,134.5,55.5,53,31,1.7096774193548387
train,patches_189.xml,200,200,patches,122,75,193,200,157.5,137.5,71,125,0.568
train,patches_19.xml,200,200,patches,20,1,72,140,46.0,70.5,52,139,0.37410071942446044
train,patches_19.xml,200,200,patches,94,38,180,200,137.0,119.0,86,162,0.5308641975308642
train,patches_19.xml,200,200,patches,24,142,105,199,64.5,170.5,81,57,1.4210526315789473
train,patches_19.xml,200,200,patches,115,1,186,37,150.5,19.0,71,36,1.9722222222222223
train,patches_190.xml,200,200,patches,21,1,82,154,51.5,77.5,61,153,0.39869281045751637
train,patches_190.xml,200,200,patches,130,21,200,63,165.0,42.0,70,42,1.6666666666666667
train,patches_190.xml,200,200,patches,123,101,200,185,161.5,143.0,77,84,0.9166666666666666
train,patches_190.xml,200,200,inclusion,136,58,160,99,148.0,78.5,24,41,0.5853658536585366
train,patches_190.xml,200,200,inclusion,172,71,194,97,183.0,84.0,22,26,0.8461538461538461
train,patches_190.xml,200,200,inclusion,6,12,27,43,16.5,27.5,21,31,0.6774193548387096
train,patches_190.xml,200,200,patches,23,151,71,200,47.0,175.5,48,49,0.9795918367346939
train,patches_191.xml,200,200,patches,27,14,79,91,53.0,52.5,52,77,0.6753246753246753
train,patches_191.xml,200,200,patches,31,117,103,200,67.0,158.5,72,83,0.8674698795180723
train,patches_191.xml,200,200,patches,91,2,184,198,137.5,100.0,93,196,0.4744897959183674
train,patches_192.xml,200,200,patches,41,70,163,189,102.0,129.5,122,119,1.0252100840336134
train,patches_192.xml,200,200,patches,33,7,84,75,58.5,41.0,51,68,0.75
train,patches_192.xml,200,200,patches,92,1,148,79,120.0,40.0,56,78,0.717948717948718
train,patches_192.xml,200,200,patches,1,91,47,168,24.0,129.5,46,77,0.5974025974025974
train,patches_193.xml,200,200,patches,62,4,136,72,99.0,38.0,74,68,1.088235294117647
train,patches_193.xml,200,200,patches,72,96,125,167,98.5,131.5,53,71,0.7464788732394366
train,patches_193.xml,200,200,patches,130,76,195,200,162.5,138.0,65,124,0.5241935483870968
train,patches_193.xml,200,200,patches,107,35,179,75,143.0,55.0,72,40,1.8
train,patches_194.xml,200,200,patches,72,1,144,199,108.0,100.0,72,198,0.36363636363636365
train,patches_194.xml,200,200,patches,146,1,200,83,173.0,42.0,54,82,0.6585365853658537
train,patches_195.xml,200,200,patches,1,1,59,146,30.0,73.5,58,145,0.4
train,patches_195.xml,200,200,patches,45,57,170,197,107.5,127.0,125,140,0.8928571428571429
train,patches_195.xml,200,200,patches,133,8,178,51,155.5,29.5,45,43,1.0465116279069768
train,patches_195.xml,200,200,patches,121,139,180,200,150.5,169.5,59,61,0.9672131147540983
train,patches_195.xml,200,200,inclusion,113,77,144,104,128.5,90.5,31,27,1.1481481481481481
train,patches_195.xml,200,200,inclusion,83,20,109,43,96.0,31.5,26,23,1.1304347826086956
train,patches_196.xml,200,200,patches,51,1,107,53,79.0,27.0,56,52,1.0769230769230769
train,patches_196.xml,200,200,patches,50,55,124,200,87.0,127.5,74,145,0.5103448275862069
train,patches_197.xml,200,200,patches,1,1,61,26,31.0,13.5,60,25,2.4
train,patches_197.xml,200,200,patches,1,66,54,193,27.5,129.5,53,127,0.41732283464566927
train,patches_197.xml,200,200,patches,111,36,187,133,149.0,84.5,76,97,0.7835051546391752
train,patches_198.xml,200,200,patches,21,1,99,198,60.0,99.5,78,197,0.39593908629441626
train,patches_198.xml,200,200,patches,158,68,200,158,179.0,113.0,42,90,0.4666666666666667
train,patches_198.xml,200,200,patches,158,68,200,158,179.0,113.0,42,90,0.4666666666666667
train,patches_198.xml,200,200,patches,109,64,154,140,131.5,102.0,45,76,0.5921052631578947
train,patches_198.xml,200,200,inclusion,1,21,21,50,11.0,35.5,20,29,0.6896551724137931
train,patches_199.xml,200,200,patches,6,6,163,131,84.5,68.5,157,125,1.256
train,patches_199.xml,200,200,patches,91,120,142,199,116.5,159.5,51,79,0.6455696202531646
train,patches_199.xml,200,200,inclusion,55,148,116,195,85.5,171.5,61,47,1.297872340425532
train,patches_2.xml,200,200,patches,36,1,98,152,67.0,76.5,62,151,0.4105960264900662
train,patches_2.xml,200,200,patches,115,52,174,190,144.5,121.0,59,138,0.427536231884058
train,patches_2.xml,200,200,patches,113,1,200,26,156.5,13.5,87,25,3.48
train,patches_20.xml,200,200,patches,56,1,115,191,85.5,96.0,59,190,0.3105263157894737
train,patches_200.xml,200,200,patches,3,1,73,189,38.0,95.0,70,188,0.3723404255319149
train,patches_200.xml,200,200,patches,133,1,200,157,166.5,79.0,67,156,0.42948717948717946
train,patches_201.xml,200,200,patches,18,17,170,134,94.0,75.5,152,117,1.2991452991452992
train,patches_201.xml,200,200,patches,1,1,50,30,25.5,15.5,49,29,1.6896551724137931
train,patches_201.xml,200,200,patches,95,124,155,185,125.0,154.5,60,61,0.9836065573770492
train,patches_201.xml,200,200,inclusion,63,140,131,197,97.0,168.5,68,57,1.1929824561403508
train,patches_202.xml,200,200,patches,30,1,183,89,106.5,45.0,153,88,1.7386363636363635
train,patches_202.xml,200,200,patches,20,108,85,199,52.5,153.5,65,91,0.7142857142857143
train,patches_202.xml,200,200,patches,145,64,185,153,165.0,108.5,40,89,0.449438202247191
train,patches_202.xml,200,200,inclusion,101,121,133,147,117.0,134.0,32,26,1.2307692307692308
train,patches_202.xml,200,200,patches,94,158,121,188,107.5,173.0,27,30,0.9
train,patches_203.xml,200,200,patches,57,127,122,200,89.5,163.5,65,73,0.8904109589041096
train,patches_203.xml,200,200,patches,29,1,122,119,75.5,60.0,93,118,0.788135593220339
train,patches_204.xml,200,200,patches,48,1,110,200,79.0,100.5,62,199,0.31155778894472363
train,patches_204.xml,200,200,patches,160,14,199,98,179.5,56.0,39,84,0.4642857142857143
train,patches_205.xml,200,200,patches,1,1,74,96,37.5,48.5,73,95,0.7684210526315789
train,patches_205.xml,200,200,patches,1,103,70,200,35.5,151.5,69,97,0.711340206185567
train,patches_205.xml,200,200,patches,108,58,195,200,151.5,129.0,87,142,0.6126760563380281
train,patches_206.xml,200,200,patches,1,1,42,98,21.5,49.5,41,97,0.422680412371134
train,patches_206.xml,200,200,patches,75,97,116,166,95.5,131.5,41,69,0.5942028985507246
train,patches_206.xml,200,200,patches,140,1,200,180,170.0,90.5,60,179,0.33519553072625696
train,patches_206.xml,200,200,inclusion,123,99,141,126,132.0,112.5,18,27,0.6666666666666666
train,patches_207.xml,200,200,patches,62,1,131,114,96.5,57.5,69,113,0.6106194690265486
train,patches_207.xml,200,200,patches,62,148,140,199,101.0,173.5,78,51,1.5294117647058822
train,patches_208.xml,200,200,patches,57,47,143,198,100.0,122.5,86,151,0.5695364238410596
train,patches_208.xml,200,200,patches,17,128,64,171,40.5,149.5,47,43,1.0930232558139534
train,patches_209.xml,200,200,patches,1,1,86,140,43.5,70.5,85,139,0.6115107913669064
train,patches_209.xml,200,200,patches,28,149,129,199,78.5,174.0,101,50,2.02
train,patches_209.xml,200,200,patches,89,1,180,144,134.5,72.5,91,143,0.6363636363636364
train,patches_21.xml,200,200,patches,32,1,109,180,70.5,90.5,77,179,0.4301675977653631
train,patches_21.xml,200,200,patches,119,1,190,199,154.5,100.0,71,198,0.35858585858585856
train,patches_210.xml,200,200,patches,1,1,59,200,30.0,100.5,58,199,0.2914572864321608
train,patches_210.xml,200,200,patches,61,1,200,191,130.5,96.0,139,190,0.7315789473684211
train,patches_210.xml,200,200,inclusion,109,149,147,188,128.0,168.5,38,39,0.9743589743589743
train,patches_211.xml,200,200,patches,54,1,103,154,78.5,77.5,49,153,0.3202614379084967
train,patches_211.xml,200,200,patches,95,61,185,197,140.0,129.0,90,136,0.6617647058823529
train,patches_211.xml,200,200,patches,2,1,44,16,23.0,8.5,42,15,2.8
train,patches_211.xml,200,200,patches,54,129,99,200,76.5,164.5,45,71,0.6338028169014085
train,patches_211.xml,200,200,inclusion,147,25,184,77,165.5,51.0,37,52,0.7115384615384616
train,patches_212.xml,200,200,patches,1,76,36,199,18.5,137.5,35,123,0.2845528455284553
train,patches_212.xml,200,200,patches,19,1,114,136,66.5,68.5,95,135,0.7037037037037037
train,patches_212.xml,200,200,patches,121,72,166,195,143.5,133.5,45,123,0.36585365853658536
train,patches_212.xml,200,200,patches,117,1,173,26,145.0,13.5,56,25,2.24
train,patches_213.xml,200,200,patches,104,1,165,112,134.5,56.5,61,111,0.5495495495495496
train,patches_213.xml,200,200,patches,16,1,65,64,40.5,32.5,49,63,0.7777777777777778
train,patches_214.xml,200,200,patches,48,83,119,178,83.5,130.5,71,95,0.7473684210526316
train,patches_214.xml,200,200,patches,99,56,183,127,141.0,91.5,84,71,1.1830985915492958
train,patches_215.xml,200,200,patches,7,1,85,109,46.0,55.0,78,108,0.7222222222222222
train,patches_215.xml,200,200,patches,125,1,196,131,160.5,66.0,71,130,0.5461538461538461
train,patches_215.xml,200,200,patches,1,87,67,193,34.0,140.0,66,106,0.6226415094339622
train,patches_215.xml,200,200,patches,60,65,133,200,96.5,132.5,73,135,0.5407407407407407
train,patches_215.xml,200,200,patches,135,136,197,200,166.0,168.0,62,64,0.96875
train,patches_216.xml,200,200,patches,61,1,97,28,79.0,14.5,36,27,1.3333333333333333
train,patches_216.xml,200,200,patches,113,1,168,67,140.5,34.0,55,66,0.8333333333333334
train,patches_216.xml,200,200,patches,22,96,167,164,94.5,130.0,145,68,2.1323529411764706
train,patches_216.xml,200,200,patches,118,168,158,199,138.0,183.5,40,31,1.2903225806451613
train,patches_216.xml,200,200,patches,14,122,62,199,38.0,160.5,48,77,0.6233766233766234
train,patches_216.xml,200,200,patches,177,1,200,30,188.5,15.5,23,29,0.7931034482758621
train,patches_217.xml,200,200,patches,2,1,49,66,25.5,33.5,47,65,0.7230769230769231
train,patches_217.xml,200,200,patches,1,167,32,200,16.5,183.5,31,33,0.9393939393939394
train,patches_217.xml,200,200,patches,1,95,46,169,23.5,132.0,45,74,0.6081081081081081
train,patches_217.xml,200,200,patches,70,88,163,198,116.5,143.0,93,110,0.8454545454545455
train,patches_217.xml,200,200,patches,107,1,196,104,151.5,52.5,89,103,0.8640776699029126
train,patches_217.xml,200,200,patches,55,1,103,33,79.0,17.0,48,32,1.5
train,patches_218.xml,200,200,patches,1,73,76,134,38.5,103.5,75,61,1.2295081967213115
train,patches_218.xml,200,200,patches,1,133,83,196,42.0,164.5,82,63,1.3015873015873016
train,patches_218.xml,200,200,patches,98,2,193,196,145.5,99.0,95,194,0.4896907216494845
train,patches_218.xml,200,200,patches,1,1,42,48,21.5,24.5,41,47,0.8723404255319149
train,patches_219.xml,200,200,patches,46,96,122,200,84.0,148.0,76,104,0.7307692307692307
train,patches_22.xml,200,200,patches,10,148,57,200,33.5,174.0,47,52,0.9038461538461539
train,patches_22.xml,200,200,patches,109,1,179,200,144.0,100.5,70,199,0.35175879396984927
train,patches_220.xml,200,200,patches,1,151,39,200,20.0,175.5,38,49,0.7755102040816326
train,patches_220.xml,200,200,patches,3,16,103,145,53.0,80.5,100,129,0.7751937984496124
train,patches_220.xml,200,200,patches,92,9,197,82,144.5,45.5,105,73,1.4383561643835616
train,patches_220.xml,200,200,patches,91,77,170,198,130.5,137.5,79,121,0.6528925619834711
train,patches_221.xml,200,200,patches,1,18,49,71,25.0,44.5,48,53,0.9056603773584906
train,patches_221.xml,200,200,patches,85,33,176,199,130.5,116.0,91,166,0.5481927710843374
train,patches_222.xml,200,200,patches,99,1,181,200,140.0,100.5,82,199,0.4120603015075377
train,patches_222.xml,200,200,patches,61,125,110,200,85.5,162.5,49,75,0.6533333333333333
train,patches_222.xml,200,200,patches,60,91,96,129,78.0,110.0,36,38,0.9473684210526315
train,patches_223.xml,200,200,patches,1,53,75,196,38.0,124.5,74,143,0.5174825174825175
train,patches_223.xml,200,200,patches,118,19,160,189,139.0,104.0,42,170,0.24705882352941178
train,patches_224.xml,200,200,patches,97,50,189,188,143.0,119.0,92,138,0.6666666666666666
train,patches_224.xml,200,200,patches,106,8,153,56,129.5,32.0,47,48,0.9791666666666666
train,patches_224.xml,200,200,patches,1,1,64,198,32.5,99.5,63,197,0.3197969543147208
train,patches_224.xml,200,200,patches,71,164,160,199,115.5,181.5,89,35,2.5428571428571427
train,patches_225.xml,200,200,patches,73,46,145,157,109.0,101.5,72,111,0.6486486486486487
train,patches_226.xml,200,200,patches,31,80,81,164,56.0,122.0,50,84,0.5952380952380952
train,patches_226.xml,200,200,patches,115,24,192,96,153.5,60.0,77,72,1.0694444444444444
train,patches_227.xml,200,200,patches,1,66,84,193,42.5,129.5,83,127,0.6535433070866141
train,patches_227.xml,200,200,patches,93,101,160,149,126.5,125.0,67,48,1.3958333333333333
train,patches_227.xml,200,200,patches,98,1,163,94,130.5,47.5,65,93,0.6989247311827957
train,patches_227.xml,200,200,patches,7,1,101,29,54.0,15.0,94,28,3.357142857142857
train,patches_227.xml,200,200,inclusion,166,164,194,188,180.0,176.0,28,24,1.1666666666666667
train,patches_228.xml,200,200,patches,13,110,70,176,41.5,143.0,57,66,0.8636363636363636
train,patches_228.xml,200,200,patches,79,12,160,198,119.5,105.0,81,186,0.43548387096774194
train,patches_229.xml,200,200,patches,70,6,166,190,118.0,98.0,96,184,0.5217391304347826
train,patches_229.xml,200,200,patches,1,1,61,29,31.0,15.0,60,28,2.142857142857143
train,patches_229.xml,200,200,patches,175,134,200,200,187.5,167.0,25,66,0.3787878787878788
train,patches_23.xml,200,200,patches,90,1,157,198,123.5,99.5,67,197,0.3401015228426396
train,patches_230.xml,200,200,patches,56,1,151,198,103.5,99.5,95,197,0.48223350253807107
train,patches_230.xml,200,200,patches,1,139,25,200,13.0,169.5,24,61,0.39344262295081966
train,patches_230.xml,200,200,patches,1,24,25,97,13.0,60.5,24,73,0.3287671232876712
train,patches_230.xml,200,200,patches,123,148,159,200,141.0,174.0,36,52,0.6923076923076923
train,patches_230.xml,200,200,inclusion,146,53,177,109,161.5,81.0,31,56,0.5535714285714286
train,patches_231.xml,200,200,patches,1,1,63,69,32.0,35.0,62,68,0.9117647058823529
train,patches_231.xml,200,200,patches,64,1,149,130,106.5,65.5,85,129,0.6589147286821705
train,patches_231.xml,200,200,patches,65,143,124,185,94.5,164.0,59,42,1.4047619047619047
train,patches_231.xml,200,200,patches,1,115,44,200,22.5,157.5,43,85,0.5058823529411764
train,patches_231.xml,200,200,patches,179,127,200,160,189.5,143.5,21,33,0.6363636363636364
train,patches_231.xml,200,200,patches,83,1,161,37,122.0,19.0,78,36,2.1666666666666665
train,patches_232.xml,200,200,patches,14,41,63,80,38.5,60.5,49,39,1.2564102564102564
train,patches_232.xml,200,200,patches,103,12,146,80,124.5,46.0,43,68,0.6323529411764706
train,patches_232.xml,200,200,patches,37,163,85,199,61.0,181.0,48,36,1.3333333333333333
train,patches_232.xml,200,200,patches,113,66,185,115,149.0,90.5,72,49,1.469387755102041
train,patches_232.xml,200,200,patches,1,1,40,25,20.5,13.0,39,24,1.625
train,patches_232.xml,200,200,patches,71,130,141,169,106.0,149.5,70,39,1.794871794871795
train,patches_233.xml,200,200,patches,68,12,169,153,118.5,82.5,101,141,0.7163120567375887
train,patches_233.xml,200,200,patches,26,127,111,186,68.5,156.5,85,59,1.4406779661016949
train,patches_234.xml,200,200,patches,9,1,80,94,44.5,47.5,71,93,0.7634408602150538
train,patches_234.xml,200,200,patches,15,107,83,146,49.0,126.5,68,39,1.7435897435897436
train,patches_234.xml,200,200,patches,126,72,189,121,157.5,96.5,63,49,1.2857142857142858
train,patches_234.xml,200,200,patches,12,157,75,199,43.5,178.0,63,42,1.5
train,patches_235.xml,200,200,patches,12,71,68,123,40.0,97.0,56,52,1.0769230769230769
train,patches_235.xml,200,200,patches,107,1,177,140,142.0,70.5,70,139,0.5035971223021583
train,patches_235.xml,200,200,patches,91,128,179,200,135.0,164.0,88,72,1.2222222222222223
train,patches_236.xml,200,200,patches,3,76,79,192,41.0,134.0,76,116,0.6551724137931034
train,patches_236.xml,200,200,patches,124,79,192,195,158.0,137.0,68,116,0.5862068965517241
train,patches_236.xml,200,200,patches,132,1,190,86,161.0,43.5,58,85,0.6823529411764706
train,patches_237.xml,200,200,patches,4,18,73,146,38.5,82.0,69,128,0.5390625
train,patches_237.xml,200,200,patches,1,149,74,200,37.5,174.5,73,51,1.4313725490196079
train,patches_237.xml,200,200,patches,106,8,177,196,141.5,102.0,71,188,0.3776595744680851
train,patches_238.xml,200,200,patches,61,62,122,151,91.5,106.5,61,89,0.6853932584269663
train,patches_238.xml,200,200,patches,51,1,124,52,87.5,26.5,73,51,1.4313725490196079
train,patches_239.xml,200,200,patches,97,32,162,142,129.5,87.0,65,110,0.5909090909090909
train,patches_239.xml,200,200,patches,20,118,72,153,46.0,135.5,52,35,1.4857142857142858
train,patches_24.xml,200,200,patches,1,14,37,200,19.0,107.0,36,186,0.1935483870967742
train,patches_24.xml,200,200,patches,135,10,185,76,160.0,43.0,50,66,0.7575757575757576
train,patches_24.xml,200,200,patches,155,96,198,142,176.5,119.0,43,46,0.9347826086956522
train,patches_240.xml,200,200,patches,120,126,192,187,156.0,156.5,72,61,1.180327868852459
train,patches_25.xml,200,200,patches,8,1,104,37,56.0,19.0,96,36,2.6666666666666665
train,patches_25.xml,200,200,patches,103,1,168,63,135.5,32.0,65,62,1.0483870967741935
train,patches_25.xml,200,200,patches,112,66,198,196,155.0,131.0,86,130,0.6615384615384615
train,patches_25.xml,200,200,patches,36,128,71,162,53.5,145.0,35,34,1.0294117647058822
train,patches_26.xml,200,200,patches,80,11,189,143,134.5,77.0,109,132,0.8257575757575758
train,patches_26.xml,200,200,patches,136,153,185,195,160.5,174.0,49,42,1.1666666666666667
train,patches_26.xml,200,200,patches,1,132,51,200,26.0,166.0,50,68,0.7352941176470589
train,patches_26.xml,200,200,patches,2,3,70,129,36.0,66.0,68,126,0.5396825396825397
train,patches_27.xml,200,200,patches,12,46,116,152,64.0,99.0,104,106,0.9811320754716981
train,patches_27.xml,200,200,patches,136,74,198,122,167.0,98.0,62,48,1.2916666666666667
train,patches_27.xml,200,200,patches,58,10,105,49,81.5,29.5,47,39,1.205128205128205
train,patches_28.xml,200,200,patches,7,91,89,200,48.0,145.5,82,109,0.7522935779816514
train,patches_28.xml,200,200,patches,113,141,195,199,154.0,170.0,82,58,1.4137931034482758
train,patches_28.xml,200,200,patches,25,1,84,54,54.5,27.5,59,53,1.1132075471698113
train,patches_29.xml,200,200,patches,60,1,133,88,96.5,44.5,73,87,0.8390804597701149
train,patches_29.xml,200,200,patches,71,100,131,179,101.0,139.5,60,79,0.759493670886076
train,patches_29.xml,200,200,patches,1,1,49,104,25.0,52.5,48,103,0.46601941747572817
train,patches_3.xml,200,200,patches,4,101,48,193,26.0,147.0,44,92,0.4782608695652174
train,patches_3.xml,200,200,patches,80,64,128,181,104.0,122.5,48,117,0.41025641025641024
train,patches_3.xml,200,200,patches,130,120,171,197,150.5,158.5,41,77,0.5324675324675324
train,patches_3.xml,200,200,patches,153,1,199,102,176.0,51.5,46,101,0.45544554455445546
train,patches_3.xml,200,200,patches,6,15,46,90,26.0,52.5,40,75,0.5333333333333333
train,patches_3.xml,200,200,patches,69,1,106,22,87.5,11.5,37,21,1.7619047619047619
train,patches_30.xml,200,200,patches,36,38,128,189,82.0,113.5,92,151,0.609271523178808
train,patches_30.xml,200,200,patches,176,1,200,38,188.0,19.5,24,37,0.6486486486486487
train,patches_31.xml,200,200,patches,58,63,130,185,94.0,124.0,72,122,0.5901639344262295
train,patches_31.xml,200,200,patches,137,104,189,176,163.0,140.0,52,72,0.7222222222222222
train,patches_32.xml,200,200,patches,31,85,105,151,68.0,118.0,74,66,1.121212121212121
train,patches_32.xml,200,200,patches,106,111,150,154,128.0,132.5,44,43,1.0232558139534884
train,patches_32.xml,200,200,patches,108,44,164,111,136.0,77.5,56,67,0.835820895522388
train,patches_33.xml,200,200,patches,73,1,134,77,103.5,39.0,61,76,0.8026315789473685
train,patches_33.xml,200,200,patches,67,121,128,168,97.5,144.5,61,47,1.297872340425532
train,patches_33.xml,200,200,patches,79,170,124,198,101.5,184.0,45,28,1.6071428571428572
train,patches_34.xml,200,200,patches,58,101,102,158,80.0,129.5,44,57,0.7719298245614035
train,patches_34.xml,200,200,patches,47,45,100,95,73.5,70.0,53,50,1.06
train,patches_34.xml,200,200,patches,145,123,191,167,168.0,145.0,46,44,1.0454545454545454
train,patches_35.xml,200,200,patches,44,2,93,60,68.5,31.0,49,58,0.8448275862068966
train,patches_35.xml,200,200,patches,141,29,183,73,162.0,51.0,42,44,0.9545454545454546
train,patches_35.xml,200,200,patches,51,109,100,199,75.5,154.0,49,90,0.5444444444444444
train,patches_36.xml,200,200,patches,16,101,70,135,43.0,118.0,54,34,1.588235294117647
train,patches_36.xml,200,200,patches,109,5,164,199,136.5,102.0,55,194,0.28350515463917525
train,patches_37.xml,200,200,patches,49,110,114,157,81.5,133.5,65,47,1.3829787234042554
train,patches_37.xml,200,200,patches,63,167,96,200,79.5,183.5,33,33,1.0
train,patches_38.xml,200,200,patches,11,1,67,198,39.0,99.5,56,197,0.28426395939086296
train,patches_38.xml,200,200,patches,132,108,196,159,164.0,133.5,64,51,1.2549019607843137
train,patches_38.xml,200,200,patches,145,155,183,200,164.0,177.5,38,45,0.8444444444444444
train,patches_39.xml,200,200,patches,68,47,107,97,87.5,72.0,39,50,0.78
train,patches_4.xml,200,200,patches,93,36,137,83,115.0,59.5,44,47,0.9361702127659575
train,patches_4.xml,200,200,patches,118,92,165,158,141.5,125.0,47,66,0.7121212121212122
train,patches_40.xml,200,200,patches,14,79,55,167,34.5,123.0,41,88,0.4659090909090909
train,patches_40.xml,200,200,patches,128,107,187,160,157.5,133.5,59,53,1.1132075471698113
train,patches_41.xml,200,200,patches,18,40,57,81,37.5,60.5,39,41,0.9512195121951219
train,patches_41.xml,200,200,patches,33,118,77,192,55.0,155.0,44,74,0.5945945945945946
train,patches_42.xml,200,200,patches,90,7,129,60,109.5,33.5,39,53,0.7358490566037735
train,patches_42.xml,200,200,patches,65,69,144,193,104.5,131.0,79,124,0.6370967741935484
train,patches_43.xml,200,200,patches,70,88,128,186,99.0,137.0,58,98,0.5918367346938775
train,patches_43.xml,200,200,patches,61,32,113,93,87.0,62.5,52,61,0.8524590163934426
train,patches_44.xml,200,200,patches,70,100,128,159,99.0,129.5,58,59,0.9830508474576272
train,patches_45.xml,200,200,patches,1,56,41,138,21.0,97.0,40,82,0.4878048780487805
train,patches_45.xml,200,200,patches,1,1,24,50,12.5,25.5,23,49,0.46938775510204084
train,patches_45.xml,200,200,patches,153,71,178,120,165.5,95.5,25,49,0.5102040816326531
train,patches_45.xml,200,200,patches,136,159,170,199,153.0,179.0,34,40,0.85
train,patches_46.xml,200,200,patches,69,91,125,187,97.0,139.0,56,96,0.5833333333333334
train,patches_46.xml,200,200,patches,85,2,134,84,109.5,43.0,49,82,0.5975609756097561
train,patches_46.xml,200,200,patches,145,29,177,79,161.0,54.0,32,50,0.64
train,patches_47.xml,200,200,patches,27,34,98,138,62.5,86.0,71,104,0.6826923076923077
train,patches_47.xml,200,200,patches,105,24,191,114,148.0,69.0,86,90,0.9555555555555556
train,patches_47.xml,200,200,patches,104,130,144,189,124.0,159.5,40,59,0.6779661016949152
train,patches_48.xml,200,200,patches,70,43,122,122,96.0,82.5,52,79,0.6582278481012658
train,patches_48.xml,200,200,patches,1,1,33,24,17.0,12.5,32,23,1.391304347826087
train,patches_49.xml,200,200,patches,11,2,49,58,30.0,30.0,38,56,0.6785714285714286
train,patches_49.xml,200,200,patches,6,142,56,200,31.0,171.0,50,58,0.8620689655172413
train,patches_49.xml,200,200,patches,136,1,198,126,167.0,63.5,62,125,0.496
train,patches_5.xml,200,200,patches,33,1,94,155,63.5,78.0,61,154,0.3961038961038961
train,patches_5.xml,200,200,patches,115,65,163,194,139.0,129.5,48,129,0.37209302325581395
train,patches_5.xml,200,200,patches,118,1,200,34,159.0,17.5,82,33,2.484848484848485
train,patches_50.xml,200,200,patches,61,2,106,58,83.5,30.0,45,56,0.8035714285714286
train,patches_50.xml,200,200,patches,80,125,119,178,99.5,151.5,39,53,0.7358490566037735
train,patches_51.xml,200,200,patches,60,59,124,139,92.0,99.0,64,80,0.8
train,patches_52.xml,200,200,patches,47,12,138,184,92.5,98.0,91,172,0.5290697674418605
train,patches_53.xml,200,200,patches,28,10,67,59,47.5,34.5,39,49,0.7959183673469388
train,patches_53.xml,200,200,patches,12,102,86,200,49.0,151.0,74,98,0.7551020408163265
train,patches_53.xml,200,200,patches,138,74,200,157,169.0,115.5,62,83,0.7469879518072289
train,patches_54.xml,200,200,patches,89,18,150,120,119.5,69.0,61,102,0.5980392156862745
train,patches_55.xml,200,200,patches,26,80,69,122,47.5,101.0,43,42,1.0238095238095237
train,patches_55.xml,200,200,patches,78,27,148,163,113.0,95.0,70,136,0.5147058823529411
train,patches_56.xml,200,200,patches,31,67,105,96,68.0,81.5,74,29,2.5517241379310347
train,patches_56.xml,200,200,patches,34,101,66,129,50.0,115.0,32,28,1.1428571428571428
train,patches_56.xml,200,200,patches,117,99,142,124,129.5,111.5,25,25,1.0
train,patches_56.xml,200,200,patches,160,82,200,144,180.0,113.0,40,62,0.6451612903225806
train,patches_57.xml,200,200,patches,87,15,129,148,108.0,81.5,42,133,0.3157894736842105
train,patches_57.xml,200,200,patches,82,154,132,200,107.0,177.0,50,46,1.0869565217391304
train,patches_58.xml,200,200,patches,22,14,60,110,41.0,62.0,38,96,0.3958333333333333
train,patches_58.xml,200,200,patches,69,26,109,84,89.0,55.0,40,58,0.6896551724137931
train,patches_58.xml,200,200,patches,30,136,70,200,50.0,168.0,40,64,0.625
train,patches_58.xml,200,200,patches,138,92,186,136,162.0,114.0,48,44,1.0909090909090908
train,patches_59.xml,200,200,patches,78,2,117,127,97.5,64.5,39,125,0.312
train,patches_59.xml,200,200,patches,69,142,123,200,96.0,171.0,54,58,0.9310344827586207
train,patches_6.xml,200,200,patches,13,6,90,200,51.5,103.0,77,194,0.39690721649484534
train,patches_6.xml,200,200,patches,84,33,197,160,140.5,96.5,113,127,0.889763779527559
train,patches_60.xml,200,200,patches,3,112,43,159,23.0,135.5,40,47,0.851063829787234
train,patches_60.xml,200,200,patches,162,151,199,199,180.5,175.0,37,48,0.7708333333333334
train,patches_60.xml,200,200,patches,143,50,191,147,167.0,98.5,48,97,0.4948453608247423
train,patches_60.xml,200,200,patches,146,1,190,43,168.0,22.0,44,42,1.0476190476190477
train,patches_61.xml,200,200,patches,76,1,124,63,100.0,32.0,48,62,0.7741935483870968
train,patches_62.xml,200,200,patches,89,34,122,126,105.5,80.0,33,92,0.358695652173913
train,patches_63.xml,200,200,patches,83,79,129,139,106.0,109.0,46,60,0.7666666666666667
train,patches_64.xml,200,200,patches,67,103,134,139,100.5,121.0,67,36,1.8611111111111112
train,patches_65.xml,200,200,patches,55,71,138,148,96.5,109.5,83,77,1.077922077922078
train,patches_66.xml,200,200,patches,35,14,72,69,53.5,41.5,37,55,0.6727272727272727
train,patches_66.xml,200,200,patches,99,75,160,148,129.5,111.5,61,73,0.8356164383561644
train,patches_67.xml,200,200,patches,15,75,81,147,48.0,111.0,66,72,0.9166666666666666
train,patches_67.xml,200,200,patches,143,35,179,108,161.0,71.5,36,73,0.4931506849315068
train,patches_67.xml,200,200,patches,163,163,194,200,178.5,181.5,31,37,0.8378378378378378
train,patches_68.xml,200,200,patches,21,32,58,110,39.5,71.0,37,78,0.47435897435897434
train,patches_68.xml,200,200,patches,160,13,199,67,179.5,40.0,39,54,0.7222222222222222
train,patches_68.xml,200,200,patches,37,163,70,200,53.5,181.5,33,37,0.8918918918918919
train,patches_69.xml,200,200,patches,39,145,87,200,63.0,172.5,48,55,0.8727272727272727
train,patches_69.xml,200,200,patches,109,147,155,200,132.0,173.5,46,53,0.8679245283018868
train,patches_7.xml,200,200,patches,32,12,123,198,77.5,105.0,91,186,0.489247311827957
train,patches_70.xml,200,200,patches,63,74,152,199,107.5,136.5,89,125,0.712
train,patches_71.xml,200,200,patches,1,1,37,51,19.0,26.0,36,50,0.72
train,patches_71.xml,200,200,patches,118,1,159,60,138.5,30.5,41,59,0.6949152542372882
train,patches_71.xml,200,200,patches,123,75,199,190,161.0,132.5,76,115,0.6608695652173913
train,patches_72.xml,200,200,patches,12,48,53,91,32.5,69.5,41,43,0.9534883720930233
train,patches_72.xml,200,200,patches,153,50,192,116,172.5,83.0,39,66,0.5909090909090909
train,patches_73.xml,200,200,patches,45,1,78,29,61.5,15.0,33,28,1.1785714285714286
train,patches_73.xml,200,200,patches,102,1,134,24,118.0,12.5,32,23,1.391304347826087
train,patches_73.xml,200,200,patches,107,138,153,177,130.0,157.5,46,39,1.1794871794871795
train,patches_74.xml,200,200,patches,3,117,43,200,23.0,158.5,40,83,0.4819277108433735
train,patches_74.xml,200,200,patches,122,2,199,158,160.5,80.0,77,156,0.4935897435897436
train,patches_75.xml,200,200,patches,55,100,95,169,75.0,134.5,40,69,0.5797101449275363
train,patches_75.xml,200,200,patches,107,24,158,110,132.5,67.0,51,86,0.5930232558139535
train,patches_76.xml,200,200,patches,70,33,123,154,96.5,93.5,53,121,0.4380165289256198
train,patches_76.xml,200,200,patches,35,1,111,21,73.0,11.0,76,20,3.8
train,patches_77.xml,200,200,patches,164,74,199,110,181.5,92.0,35,36,0.9722222222222222
train,patches_77.xml,200,200,patches,136,153,197,199,166.5,176.0,61,46,1.326086956521739
train,patches_77.xml,200,200,patches,23,1,52,32,37.5,16.5,29,31,0.9354838709677419
train,patches_78.xml,200,200,patches,9,36,47,178,28.0,107.0,38,142,0.2676056338028169
train,patches_78.xml,200,200,patches,146,119,185,179,165.5,149.0,39,60,0.65
train,patches_78.xml,200,200,patches,12,166,53,200,32.5,183.0,41,34,1.2058823529411764
train,patches_79.xml,200,200,patches,47,47,128,149,87.5,98.0,81,102,0.7941176470588235
train,patches_79.xml,200,200,patches,102,157,133,196,117.5,176.5,31,39,0.7948717948717948
train,patches_79.xml,200,200,patches,83,1,121,45,102.0,23.0,38,44,0.8636363636363636
train,patches_8.xml,200,200,patches,40,18,74,57,57.0,37.5,34,39,0.8717948717948718
train,patches_8.xml,200,200,patches,86,42,166,128,126.0,85.0,80,86,0.9302325581395349
train,patches_8.xml,200,200,patches,41,133,70,199,55.5,166.0,29,66,0.4393939393939394
train,patches_80.xml,200,200,patches,73,74,124,186,98.5,130.0,51,112,0.45535714285714285
train,patches_80.xml,200,200,patches,66,24,103,82,84.5,53.0,37,58,0.6379310344827587
train,patches_81.xml,200,200,patches,1,32,53,144,27.0,88.0,52,112,0.4642857142857143
train,patches_81.xml,200,200,patches,1,1,43,38,22.0,19.5,42,37,1.135135135135135
train,patches_81.xml,200,200,patches,134,1,182,51,158.0,26.0,48,50,0.96
train,patches_81.xml,200,200,patches,21,151,58,195,39.5,173.0,37,44,0.8409090909090909
train,patches_81.xml,200,200,patches,152,133,195,200,173.5,166.5,43,67,0.6417910447761194
train,patches_82.xml,200,200,patches,70,4,143,102,106.5,53.0,73,98,0.7448979591836735
train,patches_83.xml,200,200,patches,79,55,125,199,102.0,127.0,46,144,0.3194444444444444
train,patches_84.xml,200,200,patches,26,102,99,168,62.5,135.0,73,66,1.106060606060606
train,patches_84.xml,200,200,patches,113,72,169,189,141.0,130.5,56,117,0.47863247863247865
train,patches_84.xml,200,200,patches,114,1,159,80,136.5,40.5,45,79,0.569620253164557
train,patches_85.xml,200,200,patches,44,12,98,66,71.0,39.0,54,54,1.0
train,patches_85.xml,200,200,patches,107,1,156,79,131.5,40.0,49,78,0.6282051282051282
train,patches_86.xml,200,200,patches,40,37,145,150,92.5,93.5,105,113,0.9292035398230089
train,patches_87.xml,200,200,patches,9,7,93,67,51.0,37.0,84,60,1.4
train,patches_87.xml,200,200,patches,106,26,154,102,130.0,64.0,48,76,0.631578947368421
train,patches_87.xml,200,200,patches,114,139,198,199,156.0,169.0,84,60,1.4
train,patches_87.xml,200,200,patches,156,27,200,103,178.0,65.0,44,76,0.5789473684210527
train,patches_88.xml,200,200,patches,1,28,35,98,18.0,63.0,34,70,0.4857142857142857
train,patches_88.xml,200,200,patches,39,45,117,102,78.0,73.5,78,57,1.368421052631579
train,patches_88.xml,200,200,patches,123,15,172,138,147.5,76.5,49,123,0.3983739837398374
train,patches_88.xml,200,200,patches,1,138,87,200,44.0,169.0,86,62,1.3870967741935485
train,patches_89.xml,200,200,patches,1,1,19,36,10.0,18.5,18,35,0.5142857142857142
train,patches_89.xml,200,200,patches,29,5,70,70,49.5,37.5,41,65,0.6307692307692307
train,patches_89.xml,200,200,patches,78,8,146,72,112.0,40.0,68,64,1.0625
train,patches_89.xml,200,200,patches,156,1,198,115,177.0,58.0,42,114,0.3684210526315789
train,patches_89.xml,200,200,patches,35,113,125,200,80.0,156.5,90,87,1.0344827586206897
train,patches_89.xml,200,200,patches,173,172,200,200,186.5,186.0,27,28,0.9642857142857143
train,patches_9.xml,200,200,patches,65,66,139,138,102.0,102.0,74,72,1.0277777777777777
train,patches_90.xml,200,200,patches,69,7,162,200,115.5,103.5,93,193,0.48186528497409326
train,patches_90.xml,200,200,patches,130,120,182,200,156.0,160.0,52,80,0.65
train,patches_90.xml,200,200,patches,20,103,73,161,46.5,132.0,53,58,0.9137931034482759
train,patches_91.xml,200,200,patches,25,110,68,187,46.5,148.5,43,77,0.5584415584415584
train,patches_91.xml,200,200,patches,1,126,21,200,11.0,163.0,20,74,0.2702702702702703
train,patches_91.xml,200,200,patches,98,61,150,181,124.0,121.0,52,120,0.43333333333333335
train,patches_91.xml,200,200,patches,1,1,52,28,26.5,14.5,51,27,1.8888888888888888
train,patches_92.xml,200,200,patches,10,72,64,193,37.0,132.5,54,121,0.4462809917355372
train,patches_92.xml,200,200,patches,98,30,171,125,134.5,77.5,73,95,0.7684210526315789
train,patches_92.xml,200,200,patches,111,134,155,200,133.0,167.0,44,66,0.6666666666666666
train,patches_92.xml,200,200,patches,1,1,23,66,12.0,33.5,22,65,0.3384615384615385
train,patches_92.xml,200,200,patches,29,1,70,19,49.5,10.0,41,18,2.2777777777777777
train,patches_92.xml,200,200,patches,112,1,153,18,132.5,9.5,41,17,2.411764705882353
train,patches_93.xml,200,200,patches,10,1,76,128,43.0,64.5,66,127,0.5196850393700787
train,patches_93.xml,200,200,patches,81,9,127,82,104.0,45.5,46,73,0.6301369863013698
train,patches_93.xml,200,200,patches,69,136,120,200,94.5,168.0,51,64,0.796875
train,patches_93.xml,200,200,patches,157,101,200,200,178.5,150.5,43,99,0.43434343434343436
train,patches_93.xml,200,200,patches,163,1,200,83,181.5,42.0,37,82,0.45121951219512196
train,patches_94.xml,200,200,patches,85,73,120,127,102.5,100.0,35,54,0.6481481481481481
train,patches_95.xml,200,200,patches,89,73,170,170,129.5,121.5,81,97,0.8350515463917526
train,patches_95.xml,200,200,patches,43,74,94,145,68.5,109.5,51,71,0.7183098591549296
train,patches_95.xml,200,200,patches,174,97,200,158,187.0,127.5,26,61,0.4262295081967213
train,patches_96.xml,200,200,patches,67,51,143,165,105.0,108.0,76,114,0.6666666666666666
train,patches_97.xml,200,200,patches,75,51,133,145,104.0,98.0,58,94,0.6170212765957447
train,patches_97.xml,200,200,patches,90,146,130,193,110.0,169.5,40,47,0.851063829787234
train,patches_98.xml,200,200,patches,15,68,106,185,60.5,126.5,91,117,0.7777777777777778
train,patches_98.xml,200,200,patches,100,94,172,191,136.0,142.5,72,97,0.7422680412371134
train,patches_99.xml,200,200,patches,17,1,94,53,55.5,27.0,77,52,1.4807692307692308
train,patches_99.xml,200,200,patches,29,133,79,200,54.0,166.5,50,67,0.746268656716418
train,patches_99.xml,200,200,patches,110,45,165,199,137.5,122.0,55,154,0.35714285714285715
train,patches_99.xml,200,200,patches,105,1,156,58,130.5,29.5,51,57,0.8947368421052632
train,pitted_surface_1.xml,200,200,pitted_surface,21,2,92,196,56.5,99.0,71,194,0.36597938144329895
train,pitted_surface_1.xml,200,200,pitted_surface,85,3,188,195,136.5,99.0,103,192,0.5364583333333334
train,pitted_surface_10.xml,200,200,pitted_surface,5,56,195,194,100.0,125.0,190,138,1.3768115942028984
train,pitted_surface_100.xml,200,200,pitted_surface,60,6,198,198,129.0,102.0,138,192,0.71875
train,pitted_surface_100.xml,200,200,pitted_surface,2,2,50,194,26.0,98.0,48,192,0.25
train,pitted_surface_101.xml,200,200,pitted_surface,76,1,153,173,114.5,87.0,77,172,0.4476744186046512
train,pitted_surface_101.xml,200,200,pitted_surface,77,176,138,200,107.5,188.0,61,24,2.5416666666666665
train,pitted_surface_101.xml,200,200,pitted_surface,155,104,200,198,177.5,151.0,45,94,0.4787234042553192
train,pitted_surface_101.xml,200,200,pitted_surface,168,1,200,30,184.0,15.5,32,29,1.103448275862069
train,pitted_surface_102.xml,200,200,pitted_surface,144,1,190,20,167.0,10.5,46,19,2.4210526315789473
train,pitted_surface_102.xml,200,200,pitted_surface,161,17,199,153,180.0,85.0,38,136,0.27941176470588236
train,pitted_surface_102.xml,200,200,pitted_surface,156,158,200,199,178.0,178.5,44,41,1.0731707317073171
train,pitted_surface_102.xml,200,200,pitted_surface,88,1,147,198,117.5,99.5,59,197,0.29949238578680204
train,pitted_surface_102.xml,200,200,pitted_surface,5,11,72,192,38.5,101.5,67,181,0.3701657458563536
train,pitted_surface_103.xml,200,200,pitted_surface,17,3,95,140,56.0,71.5,78,137,0.5693430656934306
train,pitted_surface_103.xml,200,200,pitted_surface,111,1,195,189,153.0,95.0,84,188,0.44680851063829785
train,pitted_surface_104.xml,200,200,pitted_surface,3,1,138,185,70.5,93.0,135,184,0.7336956521739131
train,pitted_surface_105.xml,200,200,pitted_surface,1,1,129,188,65.0,94.5,128,187,0.6844919786096256
train,pitted_surface_106.xml,200,200,pitted_surface,82,2,197,199,139.5,100.5,115,197,0.583756345177665
train,pitted_surface_107.xml,200,200,pitted_surface,26,2,188,200,107.0,101.0,162,198,0.8181818181818182
train,pitted_surface_108.xml,200,200,pitted_surface,48,55,170,199,109.0,127.0,122,144,0.8472222222222222
train,pitted_surface_109.xml,200,200,pitted_surface,25,2,143,199,84.0,100.5,118,197,0.5989847715736041
train,pitted_surface_109.xml,200,200,pitted_surface,152,1,195,199,173.5,100.0,43,198,0.21717171717171718
train,pitted_surface_11.xml,200,200,pitted_surface,2,37,178,197,90.0,117.0,176,160,1.1
train,pitted_surface_110.xml,200,200,pitted_surface,6,1,34,199,20.0,100.0,28,198,0.1414141414141414
train,pitted_surface_110.xml,200,200,pitted_surface,26,57,196,200,111.0,128.5,170,143,1.1888111888111887
train,pitted_surface_111.xml,200,200,pitted_surface,6,18,171,196,88.5,107.0,165,178,0.9269662921348315
train,pitted_surface_111.xml,200,200,pitted_surface,53,8,177,89,115.0,48.5,124,81,1.5308641975308641
train,pitted_surface_112.xml,200,200,pitted_surface,9,25,63,191,36.0,108.0,54,166,0.3253012048192771
train,pitted_surface_112.xml,200,200,pitted_surface,70,104,131,181,100.5,142.5,61,77,0.7922077922077922
train,pitted_surface_112.xml,200,200,pitted_surface,55,39,189,96,122.0,67.5,134,57,2.3508771929824563
train,pitted_surface_112.xml,200,200,pitted_surface,159,86,197,197,178.0,141.5,38,111,0.34234234234234234
train,pitted_surface_113.xml,200,200,pitted_surface,35,3,138,198,86.5,100.5,103,195,0.5282051282051282
train,pitted_surface_113.xml,200,200,pitted_surface,168,1,198,185,183.0,93.0,30,184,0.16304347826086957
train,pitted_surface_114.xml,200,200,pitted_surface,1,1,54,189,27.5,95.0,53,188,0.28191489361702127
train,pitted_surface_114.xml,200,200,pitted_surface,78,1,119,197,98.5,99.0,41,196,0.20918367346938777
train,pitted_surface_114.xml,200,200,pitted_surface,123,1,197,75,160.0,38.0,74,74,1.0
train,pitted_surface_115.xml,200,200,pitted_surface,91,1,200,199,145.5,100.0,109,198,0.5505050505050505
train,pitted_surface_115.xml,200,200,pitted_surface,1,1,101,73,51.0,37.0,100,72,1.3888888888888888
train,pitted_surface_116.xml,200,200,pitted_surface,4,1,183,200,93.5,100.5,179,199,0.8994974874371859
train,pitted_surface_116.xml,200,200,pitted_surface,170,54,200,199,185.0,126.5,30,145,0.20689655172413793
train,pitted_surface_117.xml,200,200,pitted_surface,88,9,200,198,144.0,103.5,112,189,0.5925925925925926
train,pitted_surface_117.xml,200,200,pitted_surface,20,139,107,199,63.5,169.0,87,60,1.45
train,pitted_surface_117.xml,200,200,pitted_surface,14,18,90,197,52.0,107.5,76,179,0.4245810055865922
train,pitted_surface_118.xml,200,200,pitted_surface,23,1,184,195,103.5,98.0,161,194,0.8298969072164949
train,pitted_surface_118.xml,200,200,pitted_surface,1,168,27,200,14.0,184.0,26,32,0.8125
train,pitted_surface_119.xml,200,200,pitted_surface,6,1,129,194,67.5,97.5,123,193,0.6373056994818653
train,pitted_surface_119.xml,200,200,pitted_surface,160,2,196,164,178.0,83.0,36,162,0.2222222222222222
train,pitted_surface_12.xml,200,200,pitted_surface,2,1,195,195,98.5,98.0,193,194,0.9948453608247423
train,pitted_surface_120.xml,200,200,pitted_surface,1,1,72,198,36.5,99.5,71,197,0.3604060913705584
train,pitted_surface_120.xml,200,200,pitted_surface,79,1,160,197,119.5,99.0,81,196,0.413265306122449
train,pitted_surface_121.xml,200,200,pitted_surface,16,4,95,195,55.5,99.5,79,191,0.41361256544502617
train,pitted_surface_121.xml,200,200,pitted_surface,121,1,200,197,160.5,99.0,79,196,0.4030612244897959
train,pitted_surface_122.xml,200,200,pitted_surface,19,1,169,174,94.0,87.5,150,173,0.8670520231213873
train,pitted_surface_122.xml,200,200,pitted_surface,177,23,200,117,188.5,70.0,23,94,0.24468085106382978
train,pitted_surface_122.xml,200,200,pitted_surface,173,154,200,199,186.5,176.5,27,45,0.6
train,pitted_surface_123.xml,200,200,pitted_surface,67,1,189,195,128.0,98.0,122,194,0.6288659793814433
train,pitted_surface_124.xml,200,200,pitted_surface,1,1,103,135,52.0,68.0,102,134,0.7611940298507462
train,pitted_surface_124.xml,200,200,pitted_surface,117,1,195,54,156.0,27.5,78,53,1.471698113207547
train,pitted_surface_125.xml,200,200,pitted_surface,136,2,198,197,167.0,99.5,62,195,0.31794871794871793
train,pitted_surface_125.xml,200,200,pitted_surface,4,2,130,111,67.0,56.5,126,109,1.1559633027522935
train,pitted_surface_126.xml,200,200,pitted_surface,1,2,193,185,97.0,93.5,192,183,1.0491803278688525
train,pitted_surface_126.xml,200,200,pitted_surface,1,121,42,195,21.5,158.0,41,74,0.5540540540540541
train,pitted_surface_127.xml,200,200,pitted_surface,4,2,81,191,42.5,96.5,77,189,0.4074074074074074
train,pitted_surface_127.xml,200,200,pitted_surface,90,2,194,192,142.0,97.0,104,190,0.5473684210526316
train,pitted_surface_128.xml,200,200,pitted_surface,73,2,185,181,129.0,91.5,112,179,0.6256983240223464
train,pitted_surface_129.xml,200,200,pitted_surface,1,1,78,200,39.5,100.5,77,199,0.3869346733668342
train,pitted_surface_129.xml,200,200,pitted_surface,144,98,200,200,172.0,149.0,56,102,0.5490196078431373
train,pitted_surface_129.xml,200,200,pitted_surface,82,1,184,187,133.0,94.0,102,186,0.5483870967741935
train,pitted_surface_13.xml,200,200,pitted_surface,1,2,70,198,35.5,100.0,69,196,0.3520408163265306
train,pitted_surface_13.xml,200,200,pitted_surface,153,3,200,177,176.5,90.0,47,174,0.27011494252873564
train,pitted_surface_130.xml,200,200,pitted_surface,24,38,147,195,85.5,116.5,123,157,0.7834394904458599
train,pitted_surface_130.xml,200,200,pitted_surface,171,1,199,198,185.0,99.5,28,197,0.14213197969543148
train,pitted_surface_131.xml,200,200,pitted_surface,62,21,177,188,119.5,104.5,115,167,0.688622754491018
train,pitted_surface_132.xml,200,200,pitted_surface,58,1,175,190,116.5,95.5,117,189,0.6190476190476191
train,pitted_surface_133.xml,200,200,pitted_surface,31,1,165,151,98.0,76.0,134,150,0.8933333333333333
train,pitted_surface_134.xml,200,200,pitted_surface,1,1,166,118,83.5,59.5,165,117,1.4102564102564104
train,pitted_surface_135.xml,200,200,pitted_surface,1,2,86,193,43.5,97.5,85,191,0.44502617801047123
train,pitted_surface_135.xml,200,200,pitted_surface,112,1,199,198,155.5,99.5,87,197,0.4416243654822335
train,pitted_surface_136.xml,200,200,pitted_surface,1,1,200,198,100.5,99.5,199,197,1.0101522842639594
train,pitted_surface_137.xml,200,200,pitted_surface,2,3,99,195,50.5,99.0,97,192,0.5052083333333334
train,pitted_surface_137.xml,200,200,pitted_surface,152,3,198,196,175.0,99.5,46,193,0.23834196891191708
train,pitted_surface_138.xml,200,200,pitted_surface,10,1,200,198,105.0,99.5,190,197,0.9644670050761421
train,pitted_surface_139.xml,200,200,pitted_surface,1,3,195,195,98.0,99.0,194,192,1.0104166666666667
train,pitted_surface_14.xml,200,200,pitted_surface,2,2,195,197,98.5,99.5,193,195,0.9897435897435898
train,pitted_surface_140.xml,200,200,pitted_surface,106,1,200,197,153.0,99.0,94,196,0.47959183673469385
train,pitted_surface_140.xml,200,200,pitted_surface,2,1,73,193,37.5,97.0,71,192,0.3697916666666667
train,pitted_surface_141.xml,200,200,pitted_surface,1,1,198,200,99.5,100.5,197,199,0.9899497487437185
train,pitted_surface_142.xml,200,200,pitted_surface,4,1,196,196,100.0,98.5,192,195,0.9846153846153847
train,pitted_surface_143.xml,200,200,pitted_surface,95,1,200,199,147.5,100.0,105,198,0.5303030303030303
train,pitted_surface_144.xml,200,200,pitted_surface,1,1,199,199,100.0,100.0,198,198,1.0
train,pitted_surface_145.xml,200,200,pitted_surface,1,1,199,197,100.0,99.0,198,196,1.010204081632653
train,pitted_surface_146.xml,200,200,pitted_surface,2,5,195,195,98.5,100.0,193,190,1.0157894736842106
train,pitted_surface_147.xml,200,200,pitted_surface,2,1,199,199,100.5,100.0,197,198,0.9949494949494949
train,pitted_surface_148.xml,200,200,pitted_surface,51,7,136,198,93.5,102.5,85,191,0.44502617801047123
train,pitted_surface_148.xml,200,200,pitted_surface,2,66,57,171,29.5,118.5,55,105,0.5238095238095238
train,pitted_surface_148.xml,200,200,pitted_surface,138,146,197,199,167.5,172.5,59,53,1.1132075471698113
train,pitted_surface_148.xml,200,200,pitted_surface,132,1,196,54,164.0,27.5,64,53,1.2075471698113207
train,pitted_surface_149.xml,200,200,pitted_surface,23,1,144,199,83.5,100.0,121,198,0.6111111111111112
train,pitted_surface_149.xml,200,200,pitted_surface,159,49,198,198,178.5,123.5,39,149,0.26174496644295303
train,pitted_surface_15.xml,200,200,pitted_surface,1,1,198,199,99.5,100.0,197,198,0.9949494949494949
train,pitted_surface_150.xml,200,200,pitted_surface,42,124,123,191,82.5,157.5,81,67,1.208955223880597
train,pitted_surface_150.xml,200,200,pitted_surface,44,20,127,130,85.5,75.0,83,110,0.7545454545454545
train,pitted_surface_150.xml,200,200,pitted_surface,122,40,198,198,160.0,119.0,76,158,0.4810126582278481
train,pitted_surface_150.xml,200,200,pitted_surface,1,1,35,152,18.0,76.5,34,151,0.2251655629139073
train,pitted_surface_151.xml,200,200,pitted_surface,1,2,88,197,44.5,99.5,87,195,0.4461538461538462
train,pitted_surface_151.xml,200,200,pitted_surface,76,8,194,196,135.0,102.0,118,188,0.6276595744680851
train,pitted_surface_152.xml,200,200,pitted_surface,4,2,192,196,98.0,99.0,188,194,0.9690721649484536
train,pitted_surface_153.xml,200,200,pitted_surface,16,1,134,158,75.0,79.5,118,157,0.7515923566878981
train,pitted_surface_154.xml,200,200,pitted_surface,3,1,83,195,43.0,98.0,80,194,0.41237113402061853
train,pitted_surface_154.xml,200,200,pitted_surface,134,3,200,178,167.0,90.5,66,175,0.37714285714285717
train,pitted_surface_155.xml,200,200,pitted_surface,36,91,189,196,112.5,143.5,153,105,1.457142857142857
train,pitted_surface_155.xml,200,200,pitted_surface,10,7,196,134,103.0,70.5,186,127,1.4645669291338583
train,pitted_surface_155.xml,200,200,patches,1,1,28,61,14.5,31.0,27,60,0.45
train,pitted_surface_155.xml,200,200,patches,78,1,108,20,93.0,10.5,30,19,1.5789473684210527
train,pitted_surface_156.xml,200,200,pitted_surface,28,2,144,196,86.0,99.0,116,194,0.5979381443298969
train,pitted_surface_156.xml,200,200,patches,1,78,36,113,18.5,95.5,35,35,1.0
train,pitted_surface_157.xml,200,200,pitted_surface,11,2,196,195,103.5,98.5,185,193,0.9585492227979274
train,pitted_surface_158.xml,200,200,pitted_surface,12,8,198,198,105.0,103.0,186,190,0.9789473684210527
train,pitted_surface_159.xml,200,200,pitted_surface,14,9,188,198,101.0,103.5,174,189,0.9206349206349206
train,pitted_surface_159.xml,200,200,patches,174,1,200,48,187.0,24.5,26,47,0.5531914893617021
train,pitted_surface_16.xml,200,200,pitted_surface,1,1,199,198,100.0,99.5,198,197,1.0050761421319796
train,pitted_surface_160.xml,200,200,pitted_surface,2,10,196,198,99.0,104.0,194,188,1.0319148936170213
train,pitted_surface_160.xml,200,200,patches,153,1,198,68,175.5,34.5,45,67,0.6716417910447762
train,pitted_surface_161.xml,200,200,pitted_surface,1,11,164,198,82.5,104.5,163,187,0.8716577540106952
train,pitted_surface_161.xml,200,200,patches,92,1,197,197,144.5,99.0,105,196,0.5357142857142857
train,pitted_surface_162.xml,200,200,pitted_surface,4,9,195,191,99.5,100.0,191,182,1.0494505494505495
train,pitted_surface_162.xml,200,200,patches,159,1,200,48,179.5,24.5,41,47,0.8723404255319149
train,pitted_surface_163.xml,200,200,pitted_surface,78,1,200,200,139.0,100.5,122,199,0.6130653266331658
train,pitted_surface_163.xml,200,200,pitted_surface,12,4,74,199,43.0,101.5,62,195,0.31794871794871793
train,pitted_surface_164.xml,200,200,pitted_surface,1,1,196,200,98.5,100.5,195,199,0.9798994974874372
train,pitted_surface_165.xml,200,200,pitted_surface,1,1,159,198,80.0,99.5,158,197,0.8020304568527918
train,pitted_surface_165.xml,200,200,patches,155,21,195,187,175.0,104.0,40,166,0.24096385542168675
train,pitted_surface_166.xml,200,200,pitted_surface,1,1,93,198,47.0,99.5,92,197,0.467005076142132
train,pitted_surface_166.xml,200,200,pitted_surface,114,36,199,161,156.5,98.5,85,125,0.68
train,pitted_surface_166.xml,200,200,patches,96,1,123,127,109.5,64.0,27,126,0.21428571428571427
train,pitted_surface_167.xml,200,200,pitted_surface,1,2,188,192,94.5,97.0,187,190,0.9842105263157894
train,pitted_surface_168.xml,200,200,pitted_surface,103,1,199,194,151.0,97.5,96,193,0.49740932642487046
train,pitted_surface_168.xml,200,200,pitted_surface,27,1,101,115,64.0,58.0,74,114,0.6491228070175439
train,pitted_surface_169.xml,200,200,pitted_surface,1,1,200,198,100.5,99.5,199,197,1.0101522842639594
train,pitted_surface_17.xml,200,200,pitted_surface,1,1,199,199,100.0,100.0,198,198,1.0
train,pitted_surface_170.xml,200,200,pitted_surface,1,1,108,182,54.5,91.5,107,181,0.5911602209944752
train,pitted_surface_170.xml,200,200,pitted_surface,105,1,200,161,152.5,81.0,95,160,0.59375
train,pitted_surface_170.xml,200,200,patches,99,74,146,143,122.5,108.5,47,69,0.6811594202898551
train,pitted_surface_170.xml,200,200,patches,142,162,172,199,157.0,180.5,30,37,0.8108108108108109
train,pitted_surface_171.xml,200,200,pitted_surface,20,1,200,128,110.0,64.5,180,127,1.4173228346456692
train,pitted_surface_171.xml,200,200,patches,26,136,70,198,48.0,167.0,44,62,0.7096774193548387
train,pitted_surface_171.xml,200,200,patches,2,50,41,116,21.5,83.0,39,66,0.5909090909090909
train,pitted_surface_171.xml,200,200,pitted_surface,77,70,199,189,138.0,129.5,122,119,1.0252100840336134
train,pitted_surface_172.xml,200,200,pitted_surface,74,1,199,174,136.5,87.5,125,173,0.7225433526011561
train,pitted_surface_172.xml,200,200,patches,20,166,72,200,46.0,183.0,52,34,1.5294117647058822
train,pitted_surface_172.xml,200,200,patches,155,157,200,200,177.5,178.5,45,43,1.0465116279069768
train,pitted_surface_173.xml,200,200,pitted_surface,4,1,200,182,102.0,91.5,196,181,1.0828729281767955
train,pitted_surface_173.xml,200,200,patches,98,176,147,199,122.5,187.5,49,23,2.130434782608696
train,pitted_surface_173.xml,200,200,patches,152,155,196,200,174.0,177.5,44,45,0.9777777777777777
train,pitted_surface_174.xml,200,200,pitted_surface,1,1,184,153,92.5,77.0,183,152,1.2039473684210527
train,pitted_surface_174.xml,200,200,patches,174,46,200,115,187.0,80.5,26,69,0.37681159420289856
train,pitted_surface_174.xml,200,200,patches,37,173,95,200,66.0,186.5,58,27,2.1481481481481484
train,pitted_surface_174.xml,200,200,patches,102,149,153,200,127.5,174.5,51,51,1.0
train,pitted_surface_175.xml,200,200,pitted_surface,1,1,125,198,63.0,99.5,124,197,0.6294416243654822
train,pitted_surface_175.xml,200,200,pitted_surface,132,1,200,195,166.0,98.0,68,194,0.35051546391752575
train,pitted_surface_175.xml,200,200,patches,122,152,163,200,142.5,176.0,41,48,0.8541666666666666
train,pitted_surface_176.xml,200,200,pitted_surface,88,64,199,194,143.5,129.0,111,130,0.8538461538461538
train,pitted_surface_176.xml,200,200,pitted_surface,19,24,127,183,73.0,103.5,108,159,0.6792452830188679
train,pitted_surface_176.xml,200,200,pitted_surface,119,1,199,42,159.0,21.5,80,41,1.951219512195122
train,pitted_surface_177.xml,200,200,pitted_surface,1,13,198,190,99.5,101.5,197,177,1.112994350282486
train,pitted_surface_178.xml,200,200,pitted_surface,1,19,56,197,28.5,108.0,55,178,0.3089887640449438
train,pitted_surface_178.xml,200,200,pitted_surface,66,29,157,180,111.5,104.5,91,151,0.6026490066225165
train,pitted_surface_179.xml,200,200,pitted_surface,5,7,197,199,101.0,103.0,192,192,1.0
train,pitted_surface_18.xml,200,200,pitted_surface,63,1,199,200,131.0,100.5,136,199,0.6834170854271356
train,pitted_surface_180.xml,200,200,pitted_surface,1,1,199,199,100.0,100.0,198,198,1.0
train,pitted_surface_181.xml,200,200,pitted_surface,15,1,197,196,106.0,98.5,182,195,0.9333333333333333
train,pitted_surface_182.xml,200,200,pitted_surface,55,86,199,200,127.0,143.0,144,114,1.263157894736842
train,pitted_surface_182.xml,200,200,pitted_surface,23,1,180,95,101.5,48.0,157,94,1.6702127659574468
train,pitted_surface_183.xml,200,200,pitted_surface,3,2,145,191,74.0,96.5,142,189,0.7513227513227513
train,pitted_surface_184.xml,200,200,pitted_surface,1,1,196,195,98.5,98.0,195,194,1.0051546391752577
train,pitted_surface_185.xml,200,200,pitted_surface,5,1,200,197,102.5,99.0,195,196,0.9948979591836735
train,pitted_surface_186.xml,200,200,pitted_surface,1,7,126,199,63.5,103.0,125,192,0.6510416666666666
train,pitted_surface_187.xml,200,200,pitted_surface,72,4,177,196,124.5,100.0,105,192,0.546875
train,pitted_surface_188.xml,200,200,pitted_surface,57,1,199,199,128.0,100.0,142,198,0.7171717171717171
train,pitted_surface_189.xml,200,200,pitted_surface,3,6,155,195,79.0,100.5,152,189,0.8042328042328042
train,pitted_surface_19.xml,200,200,pitted_surface,9,1,61,197,35.0,99.0,52,196,0.2653061224489796
train,pitted_surface_19.xml,200,200,pitted_surface,77,1,199,200,138.0,100.5,122,199,0.6130653266331658
train,pitted_surface_190.xml,200,200,pitted_surface,6,2,150,74,78.0,38.0,144,72,2.0
train,pitted_surface_190.xml,200,200,pitted_surface,82,2,197,183,139.5,92.5,115,181,0.6353591160220995
train,pitted_surface_191.xml,200,200,pitted_surface,1,1,199,103,100.0,52.0,198,102,1.9411764705882353
train,pitted_surface_192.xml,200,200,pitted_surface,8,13,195,197,101.5,105.0,187,184,1.016304347826087
train,pitted_surface_193.xml,200,200,pitted_surface,3,4,197,197,100.0,100.5,194,193,1.005181347150259
train,pitted_surface_194.xml,200,200,pitted_surface,45,12,162,195,103.5,103.5,117,183,0.639344262295082
train,pitted_surface_195.xml,200,200,pitted_surface,14,57,77,193,45.5,125.0,63,136,0.4632352941176471
train,pitted_surface_195.xml,200,200,pitted_surface,101,60,147,199,124.0,129.5,46,139,0.33093525179856115
train,pitted_surface_196.xml,200,200,pitted_surface,30,1,199,116,114.5,58.5,169,115,1.4695652173913043
train,pitted_surface_197.xml,200,200,pitted_surface,114,113,199,200,156.5,156.5,85,87,0.9770114942528736
train,pitted_surface_197.xml,200,200,pitted_surface,48,3,103,198,75.5,100.5,55,195,0.28205128205128205
train,pitted_surface_197.xml,200,200,inclusion,176,92,200,116,188.0,104.0,24,24,1.0
train,pitted_surface_198.xml,200,200,pitted_surface,18,25,144,162,81.0,93.5,126,137,0.9197080291970803
train,pitted_surface_199.xml,200,200,pitted_surface,30,5,159,192,94.5,98.5,129,187,0.6898395721925134
train,pitted_surface_2.xml,200,200,pitted_surface,24,1,83,175,53.5,88.0,59,174,0.3390804597701149
train,pitted_surface_2.xml,200,200,pitted_surface,86,1,200,199,143.0,100.0,114,198,0.5757575757575758
train,pitted_surface_20.xml,200,200,pitted_surface,8,1,91,179,49.5,90.0,83,178,0.46629213483146065
train,pitted_surface_20.xml,200,200,pitted_surface,97,1,199,200,148.0,100.5,102,199,0.5125628140703518
train,pitted_surface_200.xml,200,200,pitted_surface,16,85,144,194,80.0,139.5,128,109,1.1743119266055047
train,pitted_surface_200.xml,200,200,pitted_surface,50,3,177,102,113.5,52.5,127,99,1.2828282828282829
train,pitted_surface_201.xml,200,200,pitted_surface,87,3,200,197,143.5,100.0,113,194,0.5824742268041238
train,pitted_surface_202.xml,200,200,pitted_surface,9,4,200,197,104.5,100.5,191,193,0.9896373056994818
train,pitted_surface_203.xml,200,200,pitted_surface,4,8,195,190,99.5,99.0,191,182,1.0494505494505495
train,pitted_surface_204.xml,200,200,pitted_surface,1,1,195,192,98.0,96.5,194,191,1.0157068062827226
train,pitted_surface_205.xml,200,200,pitted_surface,1,1,179,198,90.0,99.5,178,197,0.9035532994923858
train,pitted_surface_205.xml,200,200,patches,179,129,200,193,189.5,161.0,21,64,0.328125
train,pitted_surface_206.xml,200,200,pitted_surface,45,1,199,199,122.0,100.0,154,198,0.7777777777777778
train,pitted_surface_207.xml,200,200,pitted_surface,1,12,155,200,78.0,106.0,154,188,0.8191489361702128
train,pitted_surface_207.xml,200,200,patches,161,8,199,87,180.0,47.5,38,79,0.4810126582278481
train,pitted_surface_207.xml,200,200,patches,134,136,200,200,167.0,168.0,66,64,1.03125
train,pitted_surface_208.xml,200,200,pitted_surface,1,1,163,150,82.0,75.5,162,149,1.087248322147651
train,pitted_surface_208.xml,200,200,patches,75,138,147,200,111.0,169.0,72,62,1.1612903225806452
train,pitted_surface_208.xml,200,200,patches,149,75,200,199,174.5,137.0,51,124,0.4112903225806452
train,pitted_surface_209.xml,200,200,pitted_surface,45,30,196,196,120.5,113.0,151,166,0.9096385542168675
train,pitted_surface_209.xml,200,200,patches,173,4,200,38,186.5,21.0,27,34,0.7941176470588235
train,pitted_surface_21.xml,200,200,pitted_surface,2,2,198,197,100.0,99.5,196,195,1.005128205128205
train,pitted_surface_210.xml,200,200,pitted_surface,3,18,168,164,85.5,91.0,165,146,1.13013698630137
train,pitted_surface_210.xml,200,200,patches,107,1,157,17,132.0,9.0,50,16,3.125
train,pitted_surface_210.xml,200,200,patches,179,1,200,42,189.5,21.5,21,41,0.5121951219512195
train,pitted_surface_210.xml,200,200,patches,170,102,200,164,185.0,133.0,30,62,0.4838709677419355
train,pitted_surface_210.xml,200,200,patches,114,143,176,200,145.0,171.5,62,57,1.087719298245614
train,pitted_surface_211.xml,200,200,pitted_surface,75,1,199,171,137.0,86.0,124,170,0.7294117647058823
train,pitted_surface_212.xml,200,200,pitted_surface,4,1,191,195,97.5,98.0,187,194,0.9639175257731959
train,pitted_surface_213.xml,200,200,pitted_surface,19,1,185,179,102.0,90.0,166,178,0.9325842696629213
train,pitted_surface_213.xml,200,200,pitted_surface,1,19,81,199,41.0,109.0,80,180,0.4444444444444444
train,pitted_surface_214.xml,200,200,pitted_surface,2,1,163,200,82.5,100.5,161,199,0.8090452261306532
train,pitted_surface_214.xml,200,200,patches,145,89,200,199,172.5,144.0,55,110,0.5
train,pitted_surface_214.xml,200,200,patches,173,40,197,111,185.0,75.5,24,71,0.3380281690140845
train,pitted_surface_215.xml,200,200,pitted_surface,2,7,198,199,100.0,103.0,196,192,1.0208333333333333
train,pitted_surface_216.xml,200,200,pitted_surface,30,74,200,200,115.0,137.0,170,126,1.3492063492063493
train,pitted_surface_217.xml,200,200,pitted_surface,16,22,138,191,77.0,106.5,122,169,0.7218934911242604
train,pitted_surface_217.xml,200,200,pitted_surface,155,66,198,200,176.5,133.0,43,134,0.3208955223880597
train,pitted_surface_218.xml,200,200,pitted_surface,1,10,197,200,99.0,105.0,196,190,1.0315789473684212
train,pitted_surface_219.xml,200,200,pitted_surface,1,16,154,198,77.5,107.0,153,182,0.8406593406593407
train,pitted_surface_22.xml,200,200,pitted_surface,1,1,198,198,99.5,99.5,197,197,1.0
train,pitted_surface_220.xml,200,200,pitted_surface,55,1,144,200,99.5,100.5,89,199,0.4472361809045226
train,pitted_surface_220.xml,200,200,pitted_surface,135,1,198,198,166.5,99.5,63,197,0.3197969543147208
train,pitted_surface_221.xml,200,200,pitted_surface,24,2,194,192,109.0,97.0,170,190,0.8947368421052632
train,pitted_surface_222.xml,200,200,pitted_surface,5,3,172,200,88.5,101.5,167,197,0.8477157360406091
train,pitted_surface_223.xml,200,200,pitted_surface,20,1,185,200,102.5,100.5,165,199,0.8291457286432161
train,pitted_surface_223.xml,200,200,patches,1,137,37,198,19.0,167.5,36,61,0.5901639344262295
train,pitted_surface_223.xml,200,200,patches,131,172,169,200,150.0,186.0,38,28,1.3571428571428572
train,pitted_surface_224.xml,200,200,pitted_surface,1,3,177,200,89.0,101.5,176,197,0.8934010152284264
train,pitted_surface_225.xml,200,200,pitted_surface,51,4,196,198,123.5,101.0,145,194,0.7474226804123711
train,pitted_surface_226.xml,200,200,pitted_surface,2,91,81,197,41.5,144.0,79,106,0.7452830188679245
train,pitted_surface_226.xml,200,200,pitted_surface,112,7,189,192,150.5,99.5,77,185,0.41621621621621624
train,pitted_surface_226.xml,200,200,patches,4,1,43,56,23.5,28.5,39,55,0.7090909090909091
train,pitted_surface_226.xml,200,200,pitted_surface,51,14,136,178,93.5,96.0,85,164,0.5182926829268293
train,pitted_surface_227.xml,200,200,pitted_surface,34,48,199,198,116.5,123.0,165,150,1.1
train,pitted_surface_228.xml,200,200,pitted_surface,11,16,150,199,80.5,107.5,139,183,0.7595628415300546
train,pitted_surface_228.xml,200,200,pitted_surface,138,20,199,199,168.5,109.5,61,179,0.3407821229050279
train,pitted_surface_229.xml,200,200,pitted_surface,1,4,117,189,59.0,96.5,116,185,0.6270270270270271
train,pitted_surface_229.xml,200,200,pitted_surface,63,20,199,199,131.0,109.5,136,179,0.7597765363128491
train,pitted_surface_23.xml,200,200,pitted_surface,1,1,200,198,100.5,99.5,199,197,1.0101522842639594
train,pitted_surface_230.xml,200,200,pitted_surface,93,5,194,191,143.5,98.0,101,186,0.543010752688172
train,pitted_surface_230.xml,200,200,pitted_surface,5,50,156,192,80.5,121.0,151,142,1.0633802816901408
train,pitted_surface_231.xml,200,200,pitted_surface,50,5,184,171,117.0,88.0,134,166,0.8072289156626506
train,pitted_surface_231.xml,200,200,pitted_surface,1,1,50,200,25.5,100.5,49,199,0.24623115577889448
train,pitted_surface_232.xml,200,200,pitted_surface,118,8,193,200,155.5,104.0,75,192,0.390625
train,pitted_surface_233.xml,200,200,pitted_surface,162,76,198,147,180.0,111.5,36,71,0.5070422535211268
train,pitted_surface_233.xml,200,200,pitted_surface,67,7,142,183,104.5,95.0,75,176,0.42613636363636365
train,pitted_surface_234.xml,200,200,pitted_surface,21,6,95,147,58.0,76.5,74,141,0.524822695035461
train,pitted_surface_235.xml,200,200,pitted_surface,14,4,111,190,62.5,97.0,97,186,0.521505376344086
train,pitted_surface_235.xml,200,200,pitted_surface,78,50,136,182,107.0,116.0,58,132,0.4393939393939394
train,pitted_surface_236.xml,200,200,pitted_surface,31,8,166,185,98.5,96.5,135,177,0.7627118644067796
train,pitted_surface_236.xml,200,200,pitted_surface,145,2,196,199,170.5,100.5,51,197,0.25888324873096447
train,pitted_surface_237.xml,200,200,pitted_surface,22,25,191,197,106.5,111.0,169,172,0.9825581395348837
train,pitted_surface_237.xml,200,200,patches,8,2,40,27,24.0,14.5,32,25,1.28
train,pitted_surface_238.xml,200,200,pitted_surface,1,15,82,196,41.5,105.5,81,181,0.44751381215469616
train,pitted_surface_238.xml,200,200,pitted_surface,52,23,185,199,118.5,111.0,133,176,0.7556818181818182
train,pitted_surface_239.xml,200,200,pitted_surface,2,10,131,200,66.5,105.0,129,190,0.6789473684210526
train,pitted_surface_239.xml,200,200,pitted_surface,99,15,184,197,141.5,106.0,85,182,0.46703296703296704
train,pitted_surface_24.xml,200,200,pitted_surface,1,1,200,199,100.5,100.0,199,198,1.005050505050505
train,pitted_surface_240.xml,200,200,pitted_surface,11,1,194,183,102.5,92.0,183,182,1.0054945054945055
train,pitted_surface_25.xml,200,200,pitted_surface,1,1,199,198,100.0,99.5,198,197,1.0050761421319796
train,pitted_surface_26.xml,200,200,pitted_surface,35,1,200,200,117.5,100.5,165,199,0.8291457286432161
train,pitted_surface_27.xml,200,200,pitted_surface,37,1,127,188,82.0,94.5,90,187,0.48128342245989303
train,pitted_surface_27.xml,200,200,pitted_surface,119,1,200,198,159.5,99.5,81,197,0.41116751269035534
train,pitted_surface_28.xml,200,200,pitted_surface,1,1,199,199,100.0,100.0,198,198,1.0
train,pitted_surface_28.xml,200,200,pitted_surface,55,1,124,25,89.5,13.0,69,24,2.875
train,pitted_surface_29.xml,200,200,pitted_surface,1,1,197,198,99.0,99.5,196,197,0.9949238578680203
train,pitted_surface_3.xml,200,200,pitted_surface,1,1,51,184,26.0,92.5,50,183,0.273224043715847
train,pitted_surface_3.xml,200,200,pitted_surface,48,2,198,198,123.0,100.0,150,196,0.7653061224489796
train,pitted_surface_30.xml,200,200,pitted_surface,1,1,199,199,100.0,100.0,198,198,1.0
train,pitted_surface_31.xml,200,200,pitted_surface,1,1,200,199,100.5,100.0,199,198,1.005050505050505
train,pitted_surface_32.xml,200,200,pitted_surface,1,1,200,199,100.5,100.0,199,198,1.005050505050505
train,pitted_surface_33.xml,200,200,pitted_surface,9,1,199,199,104.0,100.0,190,198,0.9595959595959596
train,pitted_surface_34.xml,200,200,pitted_surface,3,1,85,197,44.0,99.0,82,196,0.41836734693877553
train,pitted_surface_34.xml,200,200,pitted_surface,93,1,200,197,146.5,99.0,107,196,0.5459183673469388
train,pitted_surface_35.xml,200,200,pitted_surface,89,1,200,186,144.5,93.5,111,185,0.6
train,pitted_surface_35.xml,200,200,pitted_surface,1,1,118,197,59.5,99.0,117,196,0.5969387755102041
train,pitted_surface_36.xml,200,200,pitted_surface,1,1,200,198,100.5,99.5,199,197,1.0101522842639594
train,pitted_surface_37.xml,200,200,pitted_surface,1,1,200,199,100.5,100.0,199,198,1.005050505050505
train,pitted_surface_38.xml,200,200,pitted_surface,1,1,200,199,100.5,100.0,199,198,1.005050505050505
train,pitted_surface_39.xml,200,200,pitted_surface,1,1,200,200,100.5,100.5,199,199,1.0
train,pitted_surface_4.xml,200,200,pitted_surface,19,2,150,199,84.5,100.5,131,197,0.6649746192893401
train,pitted_surface_40.xml,200,200,pitted_surface,3,1,200,198,101.5,99.5,197,197,1.0
train,pitted_surface_41.xml,200,200,pitted_surface,2,1,68,199,35.0,100.0,66,198,0.3333333333333333
train,pitted_surface_41.xml,200,200,pitted_surface,77,1,200,199,138.5,100.0,123,198,0.6212121212121212
train,pitted_surface_42.xml,200,200,pitted_surface,1,1,200,196,100.5,98.5,199,195,1.0205128205128204
train,pitted_surface_43.xml,200,200,pitted_surface,1,1,197,183,99.0,92.0,196,182,1.0769230769230769
train,pitted_surface_44.xml,200,200,pitted_surface,3,1,198,116,100.5,58.5,195,115,1.6956521739130435
train,pitted_surface_45.xml,200,200,pitted_surface,1,1,197,140,99.0,70.5,196,139,1.410071942446043
train,pitted_surface_46.xml,200,200,pitted_surface,1,1,51,199,26.0,100.0,50,198,0.25252525252525254
train,pitted_surface_46.xml,200,200,pitted_surface,69,1,200,196,134.5,98.5,131,195,0.6717948717948717
train,pitted_surface_47.xml,200,200,pitted_surface,118,1,199,200,158.5,100.5,81,199,0.40703517587939697
train,pitted_surface_47.xml,200,200,pitted_surface,5,1,88,199,46.5,100.0,83,198,0.41919191919191917
train,pitted_surface_48.xml,200,200,pitted_surface,2,1,196,197,99.0,99.0,194,196,0.9897959183673469
train,pitted_surface_49.xml,200,200,pitted_surface,1,1,197,198,99.0,99.5,196,197,0.9949238578680203
train,pitted_surface_5.xml,200,200,pitted_surface,1,1,193,196,97.0,98.5,192,195,0.9846153846153847
train,pitted_surface_50.xml,200,200,pitted_surface,9,1,111,200,60.0,100.5,102,199,0.5125628140703518
train,pitted_surface_50.xml,200,200,pitted_surface,117,1,200,200,158.5,100.5,83,199,0.41708542713567837
train,pitted_surface_51.xml,200,200,pitted_surface,1,1,197,200,99.0,100.5,196,199,0.9849246231155779
train,pitted_surface_52.xml,200,200,pitted_surface,1,1,199,200,100.0,100.5,198,199,0.9949748743718593
train,pitted_surface_53.xml,200,200,pitted_surface,1,1,200,198,100.5,99.5,199,197,1.0101522842639594
train,pitted_surface_54.xml,200,200,pitted_surface,3,1,197,194,100.0,97.5,194,193,1.005181347150259
train,pitted_surface_55.xml,200,200,pitted_surface,22,1,99,199,60.5,100.0,77,198,0.3888888888888889
train,pitted_surface_55.xml,200,200,pitted_surface,94,1,199,199,146.5,100.0,105,198,0.5303030303030303
train,pitted_surface_56.xml,200,200,pitted_surface,1,1,73,200,37.0,100.5,72,199,0.36180904522613067
train,pitted_surface_56.xml,200,200,pitted_surface,87,1,199,200,143.0,100.5,112,199,0.5628140703517588
train,pitted_surface_57.xml,200,200,pitted_surface,1,1,200,200,100.5,100.5,199,199,1.0
train,pitted_surface_58.xml,200,200,pitted_surface,1,1,200,198,100.5,99.5,199,197,1.0101522842639594
train,pitted_surface_59.xml,200,200,pitted_surface,6,1,76,186,41.0,93.5,70,185,0.3783783783783784
train,pitted_surface_59.xml,200,200,pitted_surface,72,1,200,199,136.0,100.0,128,198,0.6464646464646465
train,pitted_surface_6.xml,200,200,pitted_surface,1,1,197,197,99.0,99.0,196,196,1.0
train,pitted_surface_60.xml,200,200,pitted_surface,1,1,200,198,100.5,99.5,199,197,1.0101522842639594
train,pitted_surface_61.xml,200,200,pitted_surface,1,1,199,200,100.0,100.5,198,199,0.9949748743718593
train,pitted_surface_62.xml,200,200,pitted_surface,77,2,200,200,138.5,101.0,123,198,0.6212121212121212
train,pitted_surface_63.xml,200,200,pitted_surface,1,1,198,198,99.5,99.5,197,197,1.0
train,pitted_surface_64.xml,200,200,pitted_surface,1,1,200,198,100.5,99.5,199,197,1.0101522842639594
train,pitted_surface_65.xml,200,200,pitted_surface,5,1,199,195,102.0,98.0,194,194,1.0
train,pitted_surface_66.xml,200,200,pitted_surface,8,1,200,196,104.0,98.5,192,195,0.9846153846153847
train,pitted_surface_67.xml,200,200,pitted_surface,35,2,138,200,86.5,101.0,103,198,0.5202020202020202
train,pitted_surface_67.xml,200,200,pitted_surface,141,1,200,200,170.5,100.5,59,199,0.2964824120603015
train,pitted_surface_68.xml,200,200,pitted_surface,2,3,198,128,100.0,65.5,196,125,1.568
train,pitted_surface_69.xml,200,200,pitted_surface,13,1,104,133,58.5,67.0,91,132,0.6893939393939394
train,pitted_surface_69.xml,200,200,pitted_surface,137,1,200,200,168.5,100.5,63,199,0.3165829145728643
train,pitted_surface_7.xml,200,200,pitted_surface,1,1,48,198,24.5,99.5,47,197,0.23857868020304568
train,pitted_surface_7.xml,200,200,pitted_surface,38,1,200,198,119.0,99.5,162,197,0.8223350253807107
train,pitted_surface_70.xml,200,200,pitted_surface,1,1,200,200,100.5,100.5,199,199,1.0
train,pitted_surface_71.xml,200,200,pitted_surface,1,30,198,198,99.5,114.0,197,168,1.1726190476190477
train,pitted_surface_72.xml,200,200,pitted_surface,4,1,200,200,102.0,100.5,196,199,0.9849246231155779
train,pitted_surface_73.xml,200,200,pitted_surface,1,1,182,197,91.5,99.0,181,196,0.923469387755102
train,pitted_surface_73.xml,200,200,pitted_surface,137,37,199,199,168.0,118.0,62,162,0.38271604938271603
train,pitted_surface_74.xml,200,200,pitted_surface,1,1,200,198,100.5,99.5,199,197,1.0101522842639594
train,pitted_surface_75.xml,200,200,pitted_surface,87,1,200,200,143.5,100.5,113,199,0.5678391959798995
train,pitted_surface_75.xml,200,200,pitted_surface,12,1,57,192,34.5,96.5,45,191,0.2356020942408377
train,pitted_surface_76.xml,200,200,pitted_surface,1,1,200,199,100.5,100.0,199,198,1.005050505050505
train,pitted_surface_77.xml,200,200,pitted_surface,1,1,199,200,100.0,100.5,198,199,0.9949748743718593
train,pitted_surface_78.xml,200,200,pitted_surface,96,1,199,200,147.5,100.5,103,199,0.5175879396984925
train,pitted_surface_78.xml,200,200,pitted_surface,1,1,67,198,34.0,99.5,66,197,0.3350253807106599
train,pitted_surface_79.xml,200,200,pitted_surface,1,1,200,200,100.5,100.5,199,199,1.0
train,pitted_surface_8.xml,200,200,pitted_surface,1,1,199,199,100.0,100.0,198,198,1.0
train,pitted_surface_80.xml,200,200,pitted_surface,1,1,127,200,64.0,100.5,126,199,0.6331658291457286
train,pitted_surface_80.xml,200,200,pitted_surface,128,1,200,200,164.0,100.5,72,199,0.36180904522613067
train,pitted_surface_81.xml,200,200,pitted_surface,46,1,200,200,123.0,100.5,154,199,0.7738693467336684
train,pitted_surface_82.xml,200,200,pitted_surface,124,1,194,200,159.0,100.5,70,199,0.35175879396984927
train,pitted_surface_82.xml,200,200,pitted_surface,1,1,122,174,61.5,87.5,121,173,0.6994219653179191
train,pitted_surface_83.xml,200,200,pitted_surface,2,1,95,199,48.5,100.0,93,198,0.4696969696969697
train,pitted_surface_83.xml,200,200,pitted_surface,102,1,199,200,150.5,100.5,97,199,0.48743718592964824
train,pitted_surface_84.xml,200,200,pitted_surface,7,1,200,200,103.5,100.5,193,199,0.9698492462311558
train,pitted_surface_85.xml,200,200,pitted_surface,1,1,199,199,100.0,100.0,198,198,1.0
train,pitted_surface_86.xml,200,200,pitted_surface,13,1,200,200,106.5,100.5,187,199,0.9396984924623115
train,pitted_surface_87.xml,200,200,pitted_surface,1,1,56,198,28.5,99.5,55,197,0.27918781725888325
train,pitted_surface_87.xml,200,200,pitted_surface,63,1,193,135,128.0,68.0,130,134,0.9701492537313433
train,pitted_surface_88.xml,200,200,pitted_surface,1,1,200,200,100.5,100.5,199,199,1.0
train,pitted_surface_89.xml,200,200,pitted_surface,14,6,168,199,91.0,102.5,154,193,0.7979274611398963
train,pitted_surface_9.xml,200,200,pitted_surface,1,57,200,200,100.5,128.5,199,143,1.3916083916083917
train,pitted_surface_90.xml,200,200,pitted_surface,10,1,138,200,74.0,100.5,128,199,0.6432160804020101
train,pitted_surface_91.xml,200,200,pitted_surface,56,1,185,198,120.5,99.5,129,197,0.6548223350253807
train,pitted_surface_92.xml,200,200,pitted_surface,1,1,145,191,73.0,96.0,144,190,0.7578947368421053
train,pitted_surface_93.xml,200,200,pitted_surface,117,2,199,198,158.0,100.0,82,196,0.41836734693877553
train,pitted_surface_93.xml,200,200,pitted_surface,7,1,106,200,56.5,100.5,99,199,0.49748743718592964
train,pitted_surface_94.xml,200,200,pitted_surface,25,1,196,180,110.5,90.5,171,179,0.9553072625698324
train,pitted_surface_95.xml,200,200,pitted_surface,1,1,199,199,100.0,100.0,198,198,1.0
train,pitted_surface_96.xml,200,200,pitted_surface,1,1,195,199,98.0,100.0,194,198,0.9797979797979798
train,pitted_surface_97.xml,200,200,pitted_surface,1,1,200,199,100.5,100.0,199,198,1.005050505050505
train,pitted_surface_98.xml,200,200,pitted_surface,3,1,199,200,101.0,100.5,196,199,0.9849246231155779
train,pitted_surface_99.xml,200,200,pitted_surface,1,1,200,200,100.5,100.5,199,199,1.0
train,rolled-in_scale_1.xml,200,200,rolled-in_scale,63,38,139,99,101.0,68.5,76,61,1.2459016393442623
train,rolled-in_scale_1.xml,200,200,rolled-in_scale,72,111,134,169,103.0,140.0,62,58,1.0689655172413792
train,rolled-in_scale_10.xml,200,200,rolled-in_scale,59,39,122,71,90.5,55.0,63,32,1.96875
train,rolled-in_scale_10.xml,200,200,rolled-in_scale,54,83,144,139,99.0,111.0,90,56,1.6071428571428572
train,rolled-in_scale_100.xml,200,200,rolled-in_scale,34,15,110,42,72.0,28.5,76,27,2.814814814814815
train,rolled-in_scale_100.xml,200,200,rolled-in_scale,13,45,102,89,57.5,67.0,89,44,2.022727272727273
train,rolled-in_scale_100.xml,200,200,rolled-in_scale,57,87,117,154,87.0,120.5,60,67,0.8955223880597015
train,rolled-in_scale_101.xml,200,200,rolled-in_scale,100,3,175,62,137.5,32.5,75,59,1.271186440677966
train,rolled-in_scale_101.xml,200,200,rolled-in_scale,101,76,155,119,128.0,97.5,54,43,1.255813953488372
train,rolled-in_scale_102.xml,200,200,rolled-in_scale,122,21,153,49,137.5,35.0,31,28,1.1071428571428572
train,rolled-in_scale_102.xml,200,200,rolled-in_scale,66,65,132,98,99.0,81.5,66,33,2.0
train,rolled-in_scale_102.xml,200,200,rolled-in_scale,96,114,169,149,132.5,131.5,73,35,2.085714285714286
train,rolled-in_scale_102.xml,200,200,rolled-in_scale,84,151,178,199,131.0,175.0,94,48,1.9583333333333333
train,rolled-in_scale_103.xml,200,200,rolled-in_scale,93,75,200,176,146.5,125.5,107,101,1.0594059405940595
train,rolled-in_scale_104.xml,200,200,rolled-in_scale,49,67,154,159,101.5,113.0,105,92,1.141304347826087
train,rolled-in_scale_104.xml,200,200,rolled-in_scale,78,18,153,58,115.5,38.0,75,40,1.875
train,rolled-in_scale_105.xml,200,200,rolled-in_scale,1,62,103,162,52.0,112.0,102,100,1.02
train,rolled-in_scale_105.xml,200,200,rolled-in_scale,27,21,102,56,64.5,38.5,75,35,2.142857142857143
train,rolled-in_scale_106.xml,200,200,rolled-in_scale,47,22,120,136,83.5,79.0,73,114,0.6403508771929824
train,rolled-in_scale_106.xml,200,200,rolled-in_scale,71,148,173,184,122.0,166.0,102,36,2.8333333333333335
train,rolled-in_scale_107.xml,200,200,rolled-in_scale,117,94,181,198,149.0,146.0,64,104,0.6153846153846154
train,rolled-in_scale_107.xml,200,200,rolled-in_scale,73,133,115,200,94.0,166.5,42,67,0.6268656716417911
train,rolled-in_scale_108.xml,200,200,rolled-in_scale,57,36,128,154,92.5,95.0,71,118,0.6016949152542372
train,rolled-in_scale_108.xml,200,200,rolled-in_scale,15,64,60,166,37.5,115.0,45,102,0.4411764705882353
train,rolled-in_scale_109.xml,200,200,rolled-in_scale,70,68,159,198,114.5,133.0,89,130,0.6846153846153846
train,rolled-in_scale_11.xml,200,200,rolled-in_scale,33,31,91,120,62.0,75.5,58,89,0.651685393258427
train,rolled-in_scale_110.xml,200,200,rolled-in_scale,67,62,129,158,98.0,110.0,62,96,0.6458333333333334
train,rolled-in_scale_110.xml,200,200,rolled-in_scale,79,32,130,72,104.5,52.0,51,40,1.275
train,rolled-in_scale_111.xml,200,200,rolled-in_scale,149,87,190,156,169.5,121.5,41,69,0.5942028985507246
train,rolled-in_scale_112.xml,200,200,rolled-in_scale,129,81,187,200,158.0,140.5,58,119,0.48739495798319327
train,rolled-in_scale_113.xml,200,200,rolled-in_scale,69,44,135,200,102.0,122.0,66,156,0.4230769230769231
train,rolled-in_scale_113.xml,200,200,rolled-in_scale,164,47,192,131,178.0,89.0,28,84,0.3333333333333333
train,rolled-in_scale_113.xml,200,200,rolled-in_scale,159,1,199,43,179.0,22.0,40,42,0.9523809523809523
train,rolled-in_scale_114.xml,200,200,rolled-in_scale,3,6,64,195,33.5,100.5,61,189,0.32275132275132273
train,rolled-in_scale_114.xml,200,200,rolled-in_scale,88,27,125,88,106.5,57.5,37,61,0.6065573770491803
train,rolled-in_scale_115.xml,200,200,rolled-in_scale,63,42,136,152,99.5,97.0,73,110,0.6636363636363637
train,rolled-in_scale_115.xml,200,200,rolled-in_scale,161,1,197,51,179.0,26.0,36,50,0.72
train,rolled-in_scale_115.xml,200,200,rolled-in_scale,71,136,126,199,98.5,167.5,55,63,0.873015873015873
train,rolled-in_scale_115.xml,200,200,rolled-in_scale,77,2,134,63,105.5,32.5,57,61,0.9344262295081968
train,rolled-in_scale_116.xml,200,200,rolled-in_scale,81,66,125,163,103.0,114.5,44,97,0.4536082474226804
train,rolled-in_scale_117.xml,200,200,rolled-in_scale,146,113,200,192,173.0,152.5,54,79,0.6835443037974683
train,rolled-in_scale_118.xml,200,200,rolled-in_scale,83,151,123,200,103.0,175.5,40,49,0.8163265306122449
train,rolled-in_scale_118.xml,200,200,rolled-in_scale,81,66,133,128,107.0,97.0,52,62,0.8387096774193549
train,rolled-in_scale_118.xml,200,200,rolled-in_scale,77,6,121,49,99.0,27.5,44,43,1.0232558139534884
train,rolled-in_scale_119.xml,200,200,rolled-in_scale,81,1,132,45,106.5,23.0,51,44,1.1590909090909092
train,rolled-in_scale_119.xml,200,200,rolled-in_scale,86,72,131,161,108.5,116.5,45,89,0.5056179775280899
train,rolled-in_scale_12.xml,200,200,rolled-in_scale,67,13,114,51,90.5,32.0,47,38,1.236842105263158
train,rolled-in_scale_12.xml,200,200,rolled-in_scale,61,65,124,199,92.5,132.0,63,134,0.4701492537313433
train,rolled-in_scale_120.xml,200,200,rolled-in_scale,123,39,168,136,145.5,87.5,45,97,0.4639175257731959
train,rolled-in_scale_121.xml,200,200,rolled-in_scale,151,1,192,37,171.5,19.0,41,36,1.1388888888888888
train,rolled-in_scale_122.xml,200,200,rolled-in_scale,20,39,75,154,47.5,96.5,55,115,0.4782608695652174
train,rolled-in_scale_123.xml,200,200,rolled-in_scale,125,4,199,117,162.0,60.5,74,113,0.6548672566371682
train,rolled-in_scale_123.xml,200,200,rolled-in_scale,98,2,168,51,133.0,26.5,70,49,1.4285714285714286
train,rolled-in_scale_123.xml,200,200,rolled-in_scale,1,1,45,28,23.0,14.5,44,27,1.6296296296296295
train,rolled-in_scale_123.xml,200,200,rolled-in_scale,114,119,158,199,136.0,159.0,44,80,0.55
train,rolled-in_scale_124.xml,200,200,rolled-in_scale,72,10,115,141,93.5,75.5,43,131,0.3282442748091603
train,rolled-in_scale_124.xml,200,200,rolled-in_scale,160,161,195,189,177.5,175.0,35,28,1.25
train,rolled-in_scale_125.xml,200,200,rolled-in_scale,88,55,128,135,108.0,95.0,40,80,0.5
train,rolled-in_scale_125.xml,200,200,rolled-in_scale,113,15,157,40,135.0,27.5,44,25,1.76
train,rolled-in_scale_125.xml,200,200,rolled-in_scale,17,140,66,189,41.5,164.5,49,49,1.0
train,rolled-in_scale_126.xml,200,200,rolled-in_scale,71,61,110,110,90.5,85.5,39,49,0.7959183673469388
train,rolled-in_scale_126.xml,200,200,rolled-in_scale,72,126,117,200,94.5,163.0,45,74,0.6081081081081081
train,rolled-in_scale_126.xml,200,200,rolled-in_scale,143,146,199,200,171.0,173.0,56,54,1.037037037037037
train,rolled-in_scale_126.xml,200,200,rolled-in_scale,85,1,122,40,103.5,20.5,37,39,0.9487179487179487
train,rolled-in_scale_127.xml,200,200,rolled-in_scale,97,132,186,184,141.5,158.0,89,52,1.7115384615384615
train,rolled-in_scale_128.xml,200,200,rolled-in_scale,106,71,197,168,151.5,119.5,91,97,0.9381443298969072
train,rolled-in_scale_129.xml,200,200,rolled-in_scale,88,34,147,135,117.5,84.5,59,101,0.5841584158415841
train,rolled-in_scale_13.xml,200,200,rolled-in_scale,71,1,137,108,104.0,54.5,66,107,0.616822429906542
train,rolled-in_scale_13.xml,200,200,rolled-in_scale,70,118,137,183,103.5,150.5,67,65,1.0307692307692307
train,rolled-in_scale_130.xml,200,200,rolled-in_scale,117,12,146,42,131.5,27.0,29,30,0.9666666666666667
train,rolled-in_scale_130.xml,200,200,rolled-in_scale,35,129,174,188,104.5,158.5,139,59,2.3559322033898304
train,rolled-in_scale_131.xml,200,200,rolled-in_scale,72,30,164,117,118.0,73.5,92,87,1.0574712643678161
train,rolled-in_scale_131.xml,200,200,rolled-in_scale,32,105,163,173,97.5,139.0,131,68,1.9264705882352942
train,rolled-in_scale_131.xml,200,200,rolled-in_scale,25,35,91,136,58.0,85.5,66,101,0.6534653465346535
train,rolled-in_scale_132.xml,200,200,rolled-in_scale,69,5,177,69,123.0,37.0,108,64,1.6875
train,rolled-in_scale_133.xml,200,200,rolled-in_scale,41,3,122,67,81.5,35.0,81,64,1.265625
train,rolled-in_scale_133.xml,200,200,rolled-in_scale,109,78,150,160,129.5,119.0,41,82,0.5
train,rolled-in_scale_134.xml,200,200,rolled-in_scale,87,77,169,154,128.0,115.5,82,77,1.0649350649350648
train,rolled-in_scale_134.xml,200,200,rolled-in_scale,28,78,81,161,54.5,119.5,53,83,0.6385542168674698
train,rolled-in_scale_134.xml,200,200,rolled-in_scale,45,14,85,37,65.0,25.5,40,23,1.7391304347826086
train,rolled-in_scale_135.xml,200,200,rolled-in_scale,32,40,93,172,62.5,106.0,61,132,0.4621212121212121
train,rolled-in_scale_136.xml,200,200,rolled-in_scale,57,70,138,122,97.5,96.0,81,52,1.5576923076923077
train,rolled-in_scale_136.xml,200,200,rolled-in_scale,119,153,179,194,149.0,173.5,60,41,1.4634146341463414
train,rolled-in_scale_137.xml,200,200,rolled-in_scale,50,74,95,106,72.5,90.0,45,32,1.40625
train,rolled-in_scale_137.xml,200,200,rolled-in_scale,99,158,145,200,122.0,179.0,46,42,1.0952380952380953
train,rolled-in_scale_138.xml,200,200,rolled-in_scale,71,44,136,184,103.5,114.0,65,140,0.4642857142857143
train,rolled-in_scale_139.xml,200,200,rolled-in_scale,101,81,181,141,141.0,111.0,80,60,1.3333333333333333
train,rolled-in_scale_139.xml,200,200,rolled-in_scale,114,148,144,200,129.0,174.0,30,52,0.5769230769230769
train,rolled-in_scale_14.xml,200,200,rolled-in_scale,98,22,148,113,123.0,67.5,50,91,0.5494505494505495
train,rolled-in_scale_140.xml,200,200,rolled-in_scale,57,88,143,200,100.0,144.0,86,112,0.7678571428571429
train,rolled-in_scale_141.xml,200,200,rolled-in_scale,9,28,121,110,65.0,69.0,112,82,1.3658536585365855
train,rolled-in_scale_141.xml,200,200,rolled-in_scale,134,47,192,188,163.0,117.5,58,141,0.41134751773049644
train,rolled-in_scale_142.xml,200,200,rolled-in_scale,52,25,128,98,90.0,61.5,76,73,1.0410958904109588
train,rolled-in_scale_143.xml,200,200,rolled-in_scale,75,52,127,119,101.0,85.5,52,67,0.7761194029850746
train,rolled-in_scale_143.xml,200,200,rolled-in_scale,111,139,155,189,133.0,164.0,44,50,0.88
train,rolled-in_scale_144.xml,200,200,rolled-in_scale,102,67,176,140,139.0,103.5,74,73,1.0136986301369864
train,rolled-in_scale_144.xml,200,200,rolled-in_scale,49,105,94,186,71.5,145.5,45,81,0.5555555555555556
train,rolled-in_scale_144.xml,200,200,rolled-in_scale,67,18,111,78,89.0,48.0,44,60,0.7333333333333333
train,rolled-in_scale_145.xml,200,200,rolled-in_scale,33,144,101,200,67.0,172.0,68,56,1.2142857142857142
train,rolled-in_scale_145.xml,200,200,rolled-in_scale,37,13,81,80,59.0,46.5,44,67,0.6567164179104478
train,rolled-in_scale_146.xml,200,200,rolled-in_scale,92,13,130,76,111.0,44.5,38,63,0.6031746031746031
train,rolled-in_scale_146.xml,200,200,rolled-in_scale,112,128,179,185,145.5,156.5,67,57,1.1754385964912282
train,rolled-in_scale_147.xml,200,200,rolled-in_scale,84,10,144,68,114.0,39.0,60,58,1.0344827586206897
train,rolled-in_scale_147.xml,200,200,rolled-in_scale,79,86,142,155,110.5,120.5,63,69,0.9130434782608695
train,rolled-in_scale_148.xml,200,200,rolled-in_scale,122,63,178,131,150.0,97.0,56,68,0.8235294117647058
train,rolled-in_scale_148.xml,200,200,rolled-in_scale,77,9,121,59,99.0,34.0,44,50,0.88
train,rolled-in_scale_149.xml,200,200,rolled-in_scale,49,89,136,193,92.5,141.0,87,104,0.8365384615384616
train,rolled-in_scale_149.xml,200,200,rolled-in_scale,160,66,192,175,176.0,120.5,32,109,0.29357798165137616
train,rolled-in_scale_149.xml,200,200,rolled-in_scale,97,1,137,44,117.0,22.5,40,43,0.9302325581395349
train,rolled-in_scale_150.xml,200,200,rolled-in_scale,33,3,157,193,95.0,98.0,124,190,0.6526315789473685
train,rolled-in_scale_150.xml,200,200,rolled-in_scale,128,1,170,45,149.0,23.0,42,44,0.9545454545454546
train,rolled-in_scale_151.xml,200,200,rolled-in_scale,109,46,167,197,138.0,121.5,58,151,0.3841059602649007
train,rolled-in_scale_151.xml,200,200,rolled-in_scale,117,1,198,59,157.5,30.0,81,58,1.396551724137931
train,rolled-in_scale_152.xml,200,200,rolled-in_scale,2,1,54,197,28.0,99.0,52,196,0.2653061224489796
train,rolled-in_scale_152.xml,200,200,rolled-in_scale,49,6,131,63,90.0,34.5,82,57,1.4385964912280702
train,rolled-in_scale_153.xml,200,200,rolled-in_scale,71,3,129,197,100.0,100.0,58,194,0.29896907216494845
train,rolled-in_scale_153.xml,200,200,rolled-in_scale,121,4,192,72,156.5,38.0,71,68,1.0441176470588236
train,rolled-in_scale_154.xml,200,200,rolled-in_scale,123,58,195,113,159.0,85.5,72,55,1.309090909090909
train,rolled-in_scale_155.xml,200,200,rolled-in_scale,69,25,125,80,97.0,52.5,56,55,1.018181818181818
train,rolled-in_scale_156.xml,200,200,rolled-in_scale,20,28,68,182,44.0,105.0,48,154,0.3116883116883117
train,rolled-in_scale_156.xml,200,200,rolled-in_scale,97,85,147,140,122.0,112.5,50,55,0.9090909090909091
train,rolled-in_scale_157.xml,200,200,rolled-in_scale,95,22,145,52,120.0,37.0,50,30,1.6666666666666667
train,rolled-in_scale_157.xml,200,200,rolled-in_scale,59,83,136,182,97.5,132.5,77,99,0.7777777777777778
train,rolled-in_scale_158.xml,200,200,rolled-in_scale,15,120,81,192,48.0,156.0,66,72,0.9166666666666666
train,rolled-in_scale_159.xml,200,200,rolled-in_scale,31,59,74,161,52.5,110.0,43,102,0.4215686274509804
train,rolled-in_scale_16.xml,200,200,rolled-in_scale,56,94,109,192,82.5,143.0,53,98,0.5408163265306123
train,rolled-in_scale_16.xml,200,200,rolled-in_scale,157,66,183,94,170.0,80.0,26,28,0.9285714285714286
train,rolled-in_scale_160.xml,200,200,rolled-in_scale,43,1,83,73,63.0,37.0,40,72,0.5555555555555556
train,rolled-in_scale_160.xml,200,200,rolled-in_scale,39,138,84,200,61.5,169.0,45,62,0.7258064516129032
train,rolled-in_scale_160.xml,200,200,rolled-in_scale,100,149,200,200,150.0,174.5,100,51,1.9607843137254901
train,rolled-in_scale_161.xml,200,200,rolled-in_scale,37,4,89,63,63.0,33.5,52,59,0.8813559322033898
train,rolled-in_scale_161.xml,200,200,rolled-in_scale,22,150,83,200,52.5,175.0,61,50,1.22
train,rolled-in_scale_162.xml,200,200,rolled-in_scale,10,130,97,192,53.5,161.0,87,62,1.403225806451613
train,rolled-in_scale_162.xml,200,200,rolled-in_scale,6,50,98,117,52.0,83.5,92,67,1.373134328358209
train,rolled-in_scale_163.xml,200,200,rolled-in_scale,23,40,94,125,58.5,82.5,71,85,0.8352941176470589
train,rolled-in_scale_163.xml,200,200,rolled-in_scale,56,143,127,200,91.5,171.5,71,57,1.2456140350877194
train,rolled-in_scale_164.xml,200,200,rolled-in_scale,57,52,112,138,84.5,95.0,55,86,0.6395348837209303
train,rolled-in_scale_165.xml,200,200,rolled-in_scale,24,52,109,139,66.5,95.5,85,87,0.9770114942528736
train,rolled-in_scale_165.xml,200,200,rolled-in_scale,135,122,181,195,158.0,158.5,46,73,0.6301369863013698
train,rolled-in_scale_166.xml,200,200,rolled-in_scale,13,109,125,191,69.0,150.0,112,82,1.3658536585365855
train,rolled-in_scale_166.xml,200,200,rolled-in_scale,91,12,169,70,130.0,41.0,78,58,1.3448275862068966
train,rolled-in_scale_167.xml,200,200,rolled-in_scale,4,19,72,75,38.0,47.0,68,56,1.2142857142857142
train,rolled-in_scale_167.xml,200,200,rolled-in_scale,64,73,123,145,93.5,109.0,59,72,0.8194444444444444
train,rolled-in_scale_168.xml,200,200,rolled-in_scale,42,52,122,149,82.0,100.5,80,97,0.8247422680412371
train,rolled-in_scale_168.xml,200,200,rolled-in_scale,165,116,200,167,182.5,141.5,35,51,0.6862745098039216
train,rolled-in_scale_169.xml,200,200,rolled-in_scale,35,1,147,52,91.0,26.5,112,51,2.196078431372549
train,rolled-in_scale_169.xml,200,200,rolled-in_scale,23,124,139,187,81.0,155.5,116,63,1.8412698412698412
train,rolled-in_scale_17.xml,200,200,rolled-in_scale,30,18,98,77,64.0,47.5,68,59,1.152542372881356
train,rolled-in_scale_170.xml,200,200,rolled-in_scale,1,101,129,198,65.0,149.5,128,97,1.3195876288659794
train,rolled-in_scale_170.xml,200,200,rolled-in_scale,31,27,129,87,80.0,57.0,98,60,1.6333333333333333
train,rolled-in_scale_171.xml,200,200,rolled-in_scale,47,89,158,197,102.5,143.0,111,108,1.0277777777777777
train,rolled-in_scale_171.xml,200,200,rolled-in_scale,39,27,158,94,98.5,60.5,119,67,1.7761194029850746
train,rolled-in_scale_172.xml,200,200,rolled-in_scale,67,3,175,113,121.0,58.0,108,110,0.9818181818181818
train,rolled-in_scale_172.xml,200,200,rolled-in_scale,130,164,200,194,165.0,179.0,70,30,2.3333333333333335
train,rolled-in_scale_173.xml,200,200,rolled-in_scale,8,75,114,198,61.0,136.5,106,123,0.8617886178861789
train,rolled-in_scale_174.xml,200,200,rolled-in_scale,31,26,123,193,77.0,109.5,92,167,0.5508982035928144
train,rolled-in_scale_175.xml,200,200,rolled-in_scale,101,33,188,193,144.5,113.0,87,160,0.54375
train,rolled-in_scale_176.xml,200,200,rolled-in_scale,74,16,121,70,97.5,43.0,47,54,0.8703703703703703
train,rolled-in_scale_176.xml,200,200,rolled-in_scale,119,72,170,159,144.5,115.5,51,87,0.5862068965517241
train,rolled-in_scale_177.xml,200,200,rolled-in_scale,28,1,90,101,59.0,51.0,62,100,0.62
train,rolled-in_scale_177.xml,200,200,rolled-in_scale,45,117,106,198,75.5,157.5,61,81,0.7530864197530864
train,rolled-in_scale_177.xml,200,200,rolled-in_scale,96,2,183,94,139.5,48.0,87,92,0.9456521739130435
train,rolled-in_scale_178.xml,200,200,rolled-in_scale,5,45,79,183,42.0,114.0,74,138,0.5362318840579711
train,rolled-in_scale_178.xml,200,200,rolled-in_scale,63,16,162,56,112.5,36.0,99,40,2.475
train,rolled-in_scale_178.xml,200,200,rolled-in_scale,1,1,59,56,30.0,28.5,58,55,1.0545454545454545
train,rolled-in_scale_179.xml,200,200,rolled-in_scale,2,72,81,112,41.5,92.0,79,40,1.975
train,rolled-in_scale_179.xml,200,200,rolled-in_scale,4,3,81,65,42.5,34.0,77,62,1.2419354838709677
train,rolled-in_scale_18.xml,200,200,rolled-in_scale,111,98,160,196,135.5,147.0,49,98,0.5
train,rolled-in_scale_18.xml,200,200,rolled-in_scale,133,1,179,45,156.0,23.0,46,44,1.0454545454545454
train,rolled-in_scale_180.xml,200,200,rolled-in_scale,13,1,78,64,45.5,32.5,65,63,1.0317460317460319
train,rolled-in_scale_180.xml,200,200,rolled-in_scale,144,68,193,155,168.5,111.5,49,87,0.5632183908045977
train,rolled-in_scale_181.xml,200,200,rolled-in_scale,62,57,128,170,95.0,113.5,66,113,0.584070796460177
train,rolled-in_scale_182.xml,200,200,rolled-in_scale,63,59,193,171,128.0,115.0,130,112,1.1607142857142858
train,rolled-in_scale_183.xml,200,200,rolled-in_scale,29,76,103,198,66.0,137.0,74,122,0.6065573770491803
train,rolled-in_scale_183.xml,200,200,rolled-in_scale,150,65,189,186,169.5,125.5,39,121,0.32231404958677684
train,rolled-in_scale_183.xml,200,200,rolled-in_scale,35,16,151,52,93.0,34.0,116,36,3.2222222222222223
train,rolled-in_scale_184.xml,200,200,rolled-in_scale,29,91,175,199,102.0,145.0,146,108,1.3518518518518519
train,rolled-in_scale_184.xml,200,200,rolled-in_scale,9,1,95,107,52.0,54.0,86,106,0.8113207547169812
train,rolled-in_scale_184.xml,200,200,rolled-in_scale,120,1,154,54,137.0,27.5,34,53,0.6415094339622641
train,rolled-in_scale_185.xml,200,200,rolled-in_scale,3,26,55,194,29.0,110.0,52,168,0.30952380952380953
train,rolled-in_scale_185.xml,200,200,rolled-in_scale,73,28,199,160,136.0,94.0,126,132,0.9545454545454546
train,rolled-in_scale_186.xml,200,200,rolled-in_scale,45,13,200,46,122.5,29.5,155,33,4.696969696969697
train,rolled-in_scale_186.xml,200,200,rolled-in_scale,23,85,181,190,102.0,137.5,158,105,1.5047619047619047
train,rolled-in_scale_187.xml,200,200,rolled-in_scale,32,22,133,70,82.5,46.0,101,48,2.1041666666666665
train,rolled-in_scale_187.xml,200,200,rolled-in_scale,75,111,199,196,137.0,153.5,124,85,1.4588235294117646
train,rolled-in_scale_188.xml,200,200,rolled-in_scale,31,52,105,199,68.0,125.5,74,147,0.5034013605442177
train,rolled-in_scale_188.xml,200,200,rolled-in_scale,52,13,104,48,78.0,30.5,52,35,1.4857142857142858
train,rolled-in_scale_189.xml,200,200,rolled-in_scale,116,38,184,194,150.0,116.0,68,156,0.4358974358974359
train,rolled-in_scale_189.xml,200,200,rolled-in_scale,49,37,105,149,77.0,93.0,56,112,0.5
train,rolled-in_scale_19.xml,200,200,rolled-in_scale,1,50,55,197,28.0,123.5,54,147,0.3673469387755102
train,rolled-in_scale_19.xml,200,200,rolled-in_scale,125,11,178,192,151.5,101.5,53,181,0.292817679558011
train,rolled-in_scale_190.xml,200,200,rolled-in_scale,1,77,45,155,23.0,116.0,44,78,0.5641025641025641
train,rolled-in_scale_190.xml,200,200,rolled-in_scale,89,99,185,193,137.0,146.0,96,94,1.0212765957446808
train,rolled-in_scale_190.xml,200,200,rolled-in_scale,62,1,177,42,119.5,21.5,115,41,2.8048780487804876
train,rolled-in_scale_191.xml,200,200,rolled-in_scale,102,86,189,160,145.5,123.0,87,74,1.1756756756756757
train,rolled-in_scale_191.xml,200,200,rolled-in_scale,1,40,46,112,23.5,76.0,45,72,0.625
train,rolled-in_scale_192.xml,200,200,rolled-in_scale,108,155,199,198,153.5,176.5,91,43,2.116279069767442
train,rolled-in_scale_192.xml,200,200,rolled-in_scale,25,14,98,140,61.5,77.0,73,126,0.5793650793650794
train,rolled-in_scale_192.xml,200,200,rolled-in_scale,62,31,157,129,109.5,80.0,95,98,0.9693877551020408
train,rolled-in_scale_193.xml,200,200,rolled-in_scale,19,27,90,200,54.5,113.5,71,173,0.41040462427745666
train,rolled-in_scale_193.xml,200,200,rolled-in_scale,94,145,160,195,127.0,170.0,66,50,1.32
train,rolled-in_scale_193.xml,200,200,rolled-in_scale,90,39,143,66,116.5,52.5,53,27,1.962962962962963
train,rolled-in_scale_194.xml,200,200,rolled-in_scale,7,35,138,89,72.5,62.0,131,54,2.425925925925926
train,rolled-in_scale_194.xml,200,200,rolled-in_scale,27,151,127,198,77.0,174.5,100,47,2.127659574468085
train,rolled-in_scale_195.xml,200,200,rolled-in_scale,71,36,141,119,106.0,77.5,70,83,0.8433734939759037
train,rolled-in_scale_196.xml,200,200,rolled-in_scale,25,28,86,200,55.5,114.0,61,172,0.3546511627906977
train,rolled-in_scale_196.xml,200,200,rolled-in_scale,34,1,70,78,52.0,39.5,36,77,0.4675324675324675
train,rolled-in_scale_197.xml,200,200,rolled-in_scale,19,94,67,161,43.0,127.5,48,67,0.7164179104477612
train,rolled-in_scale_197.xml,200,200,rolled-in_scale,21,179,68,199,44.5,189.0,47,20,2.35
train,rolled-in_scale_197.xml,200,200,rolled-in_scale,87,122,159,200,123.0,161.0,72,78,0.9230769230769231
train,rolled-in_scale_197.xml,200,200,rolled-in_scale,100,1,157,40,128.5,20.5,57,39,1.4615384615384615
train,rolled-in_scale_198.xml,200,200,rolled-in_scale,49,1,161,75,105.0,38.0,112,74,1.5135135135135136
train,rolled-in_scale_198.xml,200,200,rolled-in_scale,29,124,127,199,78.0,161.5,98,75,1.3066666666666666
train,rolled-in_scale_198.xml,200,200,rolled-in_scale,130,139,190,198,160.0,168.5,60,59,1.0169491525423728
train,rolled-in_scale_199.xml,200,200,rolled-in_scale,4,3,90,79,47.0,41.0,86,76,1.131578947368421
train,rolled-in_scale_199.xml,200,200,rolled-in_scale,105,22,169,175,137.0,98.5,64,153,0.41830065359477125
train,rolled-in_scale_2.xml,200,200,rolled-in_scale,148,87,197,187,172.5,137.0,49,100,0.49
train,rolled-in_scale_20.xml,200,200,rolled-in_scale,28,104,77,183,52.5,143.5,49,79,0.620253164556962
train,rolled-in_scale_20.xml,200,200,rolled-in_scale,107,38,199,194,153.0,116.0,92,156,0.5897435897435898
train,rolled-in_scale_20.xml,200,200,rolled-in_scale,106,1,150,33,128.0,17.0,44,32,1.375
train,rolled-in_scale_200.xml,200,200,rolled-in_scale,61,97,164,199,112.5,148.0,103,102,1.0098039215686274
train,rolled-in_scale_200.xml,200,200,rolled-in_scale,117,110,177,158,147.0,134.0,60,48,1.25
train,rolled-in_scale_201.xml,200,200,rolled-in_scale,45,64,106,128,75.5,96.0,61,64,0.953125
train,rolled-in_scale_201.xml,200,200,rolled-in_scale,104,21,160,86,132.0,53.5,56,65,0.8615384615384616
train,rolled-in_scale_202.xml,200,200,rolled-in_scale,56,41,141,102,98.5,71.5,85,61,1.3934426229508197
train,rolled-in_scale_202.xml,200,200,rolled-in_scale,43,119,164,167,103.5,143.0,121,48,2.5208333333333335
train,rolled-in_scale_203.xml,200,200,rolled-in_scale,88,145,121,195,104.5,170.0,33,50,0.66
train,rolled-in_scale_203.xml,200,200,rolled-in_scale,113,84,149,115,131.0,99.5,36,31,1.1612903225806452
train,rolled-in_scale_203.xml,200,200,rolled-in_scale,21,93,77,138,49.0,115.5,56,45,1.2444444444444445
train,rolled-in_scale_204.xml,200,200,rolled-in_scale,102,60,168,192,135.0,126.0,66,132,0.5
train,rolled-in_scale_204.xml,200,200,rolled-in_scale,18,151,87,197,52.5,174.0,69,46,1.5
train,rolled-in_scale_205.xml,200,200,rolled-in_scale,61,47,132,199,96.5,123.0,71,152,0.46710526315789475
train,rolled-in_scale_205.xml,200,200,rolled-in_scale,129,148,199,195,164.0,171.5,70,47,1.4893617021276595
train,rolled-in_scale_205.xml,200,200,rolled-in_scale,127,43,181,70,154.0,56.5,54,27,2.0
train,rolled-in_scale_206.xml,200,200,rolled-in_scale,79,36,140,193,109.5,114.5,61,157,0.3885350318471338
train,rolled-in_scale_207.xml,200,200,rolled-in_scale,22,118,94,200,58.0,159.0,72,82,0.8780487804878049
train,rolled-in_scale_207.xml,200,200,rolled-in_scale,39,1,85,40,62.0,20.5,46,39,1.1794871794871795
train,rolled-in_scale_208.xml,200,200,rolled-in_scale,23,28,102,105,62.5,66.5,79,77,1.025974025974026
train,rolled-in_scale_208.xml,200,200,rolled-in_scale,115,51,178,194,146.5,122.5,63,143,0.4405594405594406
train,rolled-in_scale_209.xml,200,200,rolled-in_scale,40,18,132,72,86.0,45.0,92,54,1.7037037037037037
train,rolled-in_scale_209.xml,200,200,rolled-in_scale,35,76,156,197,95.5,136.5,121,121,1.0
train,rolled-in_scale_21.xml,200,200,rolled-in_scale,138,7,197,196,167.5,101.5,59,189,0.31216931216931215
train,rolled-in_scale_21.xml,200,200,rolled-in_scale,56,104,107,177,81.5,140.5,51,73,0.6986301369863014
train,rolled-in_scale_21.xml,200,200,rolled-in_scale,145,1,183,31,164.0,16.0,38,30,1.2666666666666666
train,rolled-in_scale_210.xml,200,200,rolled-in_scale,107,79,171,179,139.0,129.0,64,100,0.64
train,rolled-in_scale_210.xml,200,200,rolled-in_scale,42,38,90,98,66.0,68.0,48,60,0.8
train,rolled-in_scale_210.xml,200,200,rolled-in_scale,62,139,105,188,83.5,163.5,43,49,0.8775510204081632
train,rolled-in_scale_211.xml,200,200,rolled-in_scale,94,4,168,88,131.0,46.0,74,84,0.8809523809523809
train,rolled-in_scale_211.xml,200,200,rolled-in_scale,117,97,164,198,140.5,147.5,47,101,0.46534653465346537
train,rolled-in_scale_212.xml,200,200,rolled-in_scale,81,40,175,106,128.0,73.0,94,66,1.4242424242424243
train,rolled-in_scale_212.xml,200,200,rolled-in_scale,66,1,106,59,86.0,30.0,40,58,0.6896551724137931
train,rolled-in_scale_212.xml,200,200,rolled-in_scale,69,125,136,191,102.5,158.0,67,66,1.0151515151515151
train,rolled-in_scale_213.xml,200,200,rolled-in_scale,51,89,179,199,115.0,144.0,128,110,1.1636363636363636
train,rolled-in_scale_214.xml,200,200,rolled-in_scale,91,29,122,79,106.5,54.0,31,50,0.62
train,rolled-in_scale_214.xml,200,200,rolled-in_scale,74,164,117,198,95.5,181.0,43,34,1.2647058823529411
train,rolled-in_scale_214.xml,200,200,rolled-in_scale,165,41,189,121,177.0,81.0,24,80,0.3
train,rolled-in_scale_214.xml,200,200,rolled-in_scale,79,123,116,152,97.5,137.5,37,29,1.2758620689655173
train,rolled-in_scale_215.xml,200,200,rolled-in_scale,42,76,84,136,63.0,106.0,42,60,0.7
train,rolled-in_scale_215.xml,200,200,rolled-in_scale,112,35,157,194,134.5,114.5,45,159,0.2830188679245283
train,rolled-in_scale_216.xml,200,200,rolled-in_scale,14,71,69,175,41.5,123.0,55,104,0.5288461538461539
train,rolled-in_scale_216.xml,200,200,rolled-in_scale,83,69,156,165,119.5,117.0,73,96,0.7604166666666666
train,rolled-in_scale_217.xml,200,200,rolled-in_scale,13,31,68,83,40.5,57.0,55,52,1.0576923076923077
train,rolled-in_scale_217.xml,200,200,rolled-in_scale,29,126,71,168,50.0,147.0,42,42,1.0
train,rolled-in_scale_218.xml,200,200,rolled-in_scale,69,28,146,156,107.5,92.0,77,128,0.6015625
train,rolled-in_scale_219.xml,200,200,rolled-in_scale,98,41,190,121,144.0,81.0,92,80,1.15
train,rolled-in_scale_219.xml,200,200,rolled-in_scale,65,128,163,199,114.0,163.5,98,71,1.380281690140845
train,rolled-in_scale_22.xml,200,200,rolled-in_scale,104,75,151,168,127.5,121.5,47,93,0.5053763440860215
train,rolled-in_scale_220.xml,200,200,rolled-in_scale,19,125,131,192,75.0,158.5,112,67,1.671641791044776
train,rolled-in_scale_221.xml,200,200,rolled-in_scale,96,32,149,164,122.5,98.0,53,132,0.4015151515151515
train,rolled-in_scale_222.xml,200,200,rolled-in_scale,140,136,198,198,169.0,167.0,58,62,0.9354838709677419
train,rolled-in_scale_222.xml,200,200,rolled-in_scale,112,45,179,170,145.5,107.5,67,125,0.536
train,rolled-in_scale_223.xml,200,200,rolled-in_scale,62,4,96,32,79.0,18.0,34,28,1.2142857142857142
train,rolled-in_scale_223.xml,200,200,rolled-in_scale,25,113,91,155,58.0,134.0,66,42,1.5714285714285714
train,rolled-in_scale_224.xml,200,200,rolled-in_scale,14,66,121,199,67.5,132.5,107,133,0.8045112781954887
train,rolled-in_scale_224.xml,200,200,rolled-in_scale,114,104,192,189,153.0,146.5,78,85,0.9176470588235294
train,rolled-in_scale_224.xml,200,200,rolled-in_scale,17,18,145,101,81.0,59.5,128,83,1.5421686746987953
train,rolled-in_scale_225.xml,200,200,rolled-in_scale,18,26,106,148,62.0,87.0,88,122,0.7213114754098361
train,rolled-in_scale_225.xml,200,200,rolled-in_scale,134,47,200,122,167.0,84.5,66,75,0.88
train,rolled-in_scale_226.xml,200,200,rolled-in_scale,71,1,150,55,110.5,28.0,79,54,1.462962962962963
train,rolled-in_scale_226.xml,200,200,rolled-in_scale,84,71,158,152,121.0,111.5,74,81,0.9135802469135802
train,rolled-in_scale_227.xml,200,200,rolled-in_scale,44,110,184,198,114.0,154.0,140,88,1.5909090909090908
train,rolled-in_scale_228.xml,200,200,rolled-in_scale,47,1,157,88,102.0,44.5,110,87,1.264367816091954
train,rolled-in_scale_228.xml,200,200,rolled-in_scale,60,102,176,199,118.0,150.5,116,97,1.1958762886597938
train,rolled-in_scale_229.xml,200,200,rolled-in_scale,93,43,199,200,146.0,121.5,106,157,0.6751592356687898
train,rolled-in_scale_229.xml,200,200,rolled-in_scale,90,15,177,90,133.5,52.5,87,75,1.16
train,rolled-in_scale_23.xml,200,200,rolled-in_scale,134,83,194,200,164.0,141.5,60,117,0.5128205128205128
train,rolled-in_scale_23.xml,200,200,rolled-in_scale,59,50,108,140,83.5,95.0,49,90,0.5444444444444444
train,rolled-in_scale_230.xml,200,200,rolled-in_scale,14,1,114,134,64.0,67.5,100,133,0.7518796992481203
train,rolled-in_scale_231.xml,200,200,rolled-in_scale,1,1,57,37,29.0,19.0,56,36,1.5555555555555556
train,rolled-in_scale_231.xml,200,200,rolled-in_scale,1,94,66,178,33.5,136.0,65,84,0.7738095238095238
train,rolled-in_scale_231.xml,200,200,rolled-in_scale,109,117,161,196,135.0,156.5,52,79,0.6582278481012658
train,rolled-in_scale_232.xml,200,200,rolled-in_scale,43,23,118,129,80.5,76.0,75,106,0.7075471698113207
train,rolled-in_scale_233.xml,200,200,rolled-in_scale,17,73,83,198,50.0,135.5,66,125,0.528
train,rolled-in_scale_234.xml,200,200,rolled-in_scale,9,82,82,194,45.5,138.0,73,112,0.6517857142857143
train,rolled-in_scale_234.xml,200,200,rolled-in_scale,48,1,88,46,68.0,23.5,40,45,0.8888888888888888
train,rolled-in_scale_235.xml,200,200,rolled-in_scale,14,83,102,159,58.0,121.0,88,76,1.1578947368421053
train,rolled-in_scale_235.xml,200,200,rolled-in_scale,23,12,111,66,67.0,39.0,88,54,1.6296296296296295
train,rolled-in_scale_236.xml,200,200,rolled-in_scale,46,50,145,138,95.5,94.0,99,88,1.125
train,rolled-in_scale_237.xml,200,200,rolled-in_scale,83,24,163,66,123.0,45.0,80,42,1.9047619047619047
train,rolled-in_scale_237.xml,200,200,rolled-in_scale,84,71,175,179,129.5,125.0,91,108,0.8425925925925926
train,rolled-in_scale_238.xml,200,200,rolled-in_scale,29,27,153,171,91.0,99.0,124,144,0.8611111111111112
train,rolled-in_scale_238.xml,200,200,rolled-in_scale,38,138,128,195,83.0,166.5,90,57,1.5789473684210527
train,rolled-in_scale_239.xml,200,200,rolled-in_scale,68,76,128,147,98.0,111.5,60,71,0.8450704225352113
train,rolled-in_scale_24.xml,200,200,rolled-in_scale,31,1,79,50,55.0,25.5,48,49,0.9795918367346939
train,rolled-in_scale_24.xml,200,200,rolled-in_scale,3,101,72,191,37.5,146.0,69,90,0.7666666666666667
train,rolled-in_scale_24.xml,200,200,rolled-in_scale,160,59,187,89,173.5,74.0,27,30,0.9
train,rolled-in_scale_240.xml,200,200,rolled-in_scale,58,24,139,162,98.5,93.0,81,138,0.5869565217391305
train,rolled-in_scale_25.xml,200,200,rolled-in_scale,53,48,106,163,79.5,105.5,53,115,0.4608695652173913
train,rolled-in_scale_25.xml,200,200,rolled-in_scale,137,127,178,193,157.5,160.0,41,66,0.6212121212121212
train,rolled-in_scale_26.xml,200,200,rolled-in_scale,19,129,69,173,44.0,151.0,50,44,1.1363636363636365
train,rolled-in_scale_26.xml,200,200,rolled-in_scale,52,20,86,91,69.0,55.5,34,71,0.4788732394366197
train,rolled-in_scale_26.xml,200,200,rolled-in_scale,114,60,157,119,135.5,89.5,43,59,0.7288135593220338
train,rolled-in_scale_28.xml,200,200,rolled-in_scale,90,67,150,136,120.0,101.5,60,69,0.8695652173913043
train,rolled-in_scale_29.xml,200,200,rolled-in_scale,36,74,72,123,54.0,98.5,36,49,0.7346938775510204
train,rolled-in_scale_29.xml,200,200,rolled-in_scale,90,134,131,163,110.5,148.5,41,29,1.4137931034482758
train,rolled-in_scale_29.xml,200,200,rolled-in_scale,128,2,192,37,160.0,19.5,64,35,1.8285714285714285
train,rolled-in_scale_3.xml,200,200,rolled-in_scale,68,63,139,139,103.5,101.0,71,76,0.9342105263157895
train,rolled-in_scale_3.xml,200,200,rolled-in_scale,99,1,145,39,122.0,20.0,46,38,1.2105263157894737
train,rolled-in_scale_30.xml,200,200,rolled-in_scale,43,84,81,112,62.0,98.0,38,28,1.3571428571428572
train,rolled-in_scale_30.xml,200,200,rolled-in_scale,52,20,149,47,100.5,33.5,97,27,3.5925925925925926
train,rolled-in_scale_31.xml,200,200,rolled-in_scale,81,128,151,191,116.0,159.5,70,63,1.1111111111111112
train,rolled-in_scale_32.xml,200,200,rolled-in_scale,85,37,137,103,111.0,70.0,52,66,0.7878787878787878
train,rolled-in_scale_33.xml,200,200,rolled-in_scale,119,31,172,123,145.5,77.0,53,92,0.5760869565217391
train,rolled-in_scale_34.xml,200,200,rolled-in_scale,43,18,91,70,67.0,44.0,48,52,0.9230769230769231
train,rolled-in_scale_35.xml,200,200,rolled-in_scale,126,8,181,58,153.5,33.0,55,50,1.1
train,rolled-in_scale_35.xml,200,200,rolled-in_scale,117,77,166,127,141.5,102.0,49,50,0.98
train,rolled-in_scale_35.xml,200,200,rolled-in_scale,123,165,193,199,158.0,182.0,70,34,2.0588235294117645
train,rolled-in_scale_36.xml,200,200,rolled-in_scale,92,9,140,56,116.0,32.5,48,47,1.0212765957446808
train,rolled-in_scale_36.xml,200,200,rolled-in_scale,84,163,154,199,119.0,181.0,70,36,1.9444444444444444
train,rolled-in_scale_36.xml,200,200,rolled-in_scale,76,69,136,134,106.0,101.5,60,65,0.9230769230769231
train,rolled-in_scale_36.xml,200,200,rolled-in_scale,65,30,124,91,94.5,60.5,59,61,0.9672131147540983
train,rolled-in_scale_37.xml,200,200,rolled-in_scale,32,13,82,99,57.0,56.0,50,86,0.5813953488372093
train,rolled-in_scale_37.xml,200,200,rolled-in_scale,46,164,119,199,82.5,181.5,73,35,2.085714285714286
train,rolled-in_scale_37.xml,200,200,rolled-in_scale,37,74,94,132,65.5,103.0,57,58,0.9827586206896551
train,rolled-in_scale_37.xml,200,200,rolled-in_scale,55,21,106,61,80.5,41.0,51,40,1.275
train,rolled-in_scale_38.xml,200,200,rolled-in_scale,117,94,191,189,154.0,141.5,74,95,0.7789473684210526
train,rolled-in_scale_38.xml,200,200,rolled-in_scale,116,16,191,48,153.5,32.0,75,32,2.34375
train,rolled-in_scale_39.xml,200,200,rolled-in_scale,68,96,136,190,102.0,143.0,68,94,0.723404255319149
train,rolled-in_scale_39.xml,200,200,rolled-in_scale,57,7,110,52,83.5,29.5,53,45,1.1777777777777778
train,rolled-in_scale_39.xml,200,200,rolled-in_scale,46,148,156,186,101.0,167.0,110,38,2.8947368421052633
train,rolled-in_scale_4.xml,200,200,rolled-in_scale,40,132,138,199,89.0,165.5,98,67,1.462686567164179
train,rolled-in_scale_4.xml,200,200,rolled-in_scale,81,1,125,92,103.0,46.5,44,91,0.4835164835164835
train,rolled-in_scale_40.xml,200,200,rolled-in_scale,12,10,60,63,36.0,36.5,48,53,0.9056603773584906
train,rolled-in_scale_40.xml,200,200,rolled-in_scale,132,20,187,64,159.5,42.0,55,44,1.25
train,rolled-in_scale_40.xml,200,200,rolled-in_scale,1,101,83,140,42.0,120.5,82,39,2.1025641025641026
train,rolled-in_scale_40.xml,200,200,rolled-in_scale,3,159,80,191,41.5,175.0,77,32,2.40625
train,rolled-in_scale_41.xml,200,200,rolled-in_scale,128,66,197,199,162.5,132.5,69,133,0.518796992481203
train,rolled-in_scale_41.xml,200,200,rolled-in_scale,120,1,192,34,156.0,17.5,72,33,2.1818181818181817
train,rolled-in_scale_42.xml,200,200,rolled-in_scale,82,77,155,198,118.5,137.5,73,121,0.6033057851239669
train,rolled-in_scale_42.xml,200,200,rolled-in_scale,71,8,138,36,104.5,22.0,67,28,2.392857142857143
train,rolled-in_scale_43.xml,200,200,rolled-in_scale,37,92,109,197,73.0,144.5,72,105,0.6857142857142857
train,rolled-in_scale_43.xml,200,200,rolled-in_scale,20,7,94,40,57.0,23.5,74,33,2.242424242424242
train,rolled-in_scale_43.xml,200,200,rolled-in_scale,23,14,88,96,55.5,55.0,65,82,0.7926829268292683
train,rolled-in_scale_44.xml,200,200,rolled-in_scale,121,119,168,199,144.5,159.0,47,80,0.5875
train,rolled-in_scale_44.xml,200,200,rolled-in_scale,143,9,186,64,164.5,36.5,43,55,0.7818181818181819
train,rolled-in_scale_45.xml,200,200,rolled-in_scale,119,68,170,131,144.5,99.5,51,63,0.8095238095238095
train,rolled-in_scale_45.xml,200,200,rolled-in_scale,126,144,168,199,147.0,171.5,42,55,0.7636363636363637
train,rolled-in_scale_46.xml,200,200,rolled-in_scale,18,111,67,200,42.5,155.5,49,89,0.550561797752809
train,rolled-in_scale_46.xml,200,200,rolled-in_scale,41,1,85,58,63.0,29.5,44,57,0.7719298245614035
train,rolled-in_scale_47.xml,200,200,rolled-in_scale,48,17,99,91,73.5,54.0,51,74,0.6891891891891891
train,rolled-in_scale_47.xml,200,200,rolled-in_scale,33,103,109,199,71.0,151.0,76,96,0.7916666666666666
train,rolled-in_scale_48.xml,200,200,rolled-in_scale,133,127,200,197,166.5,162.0,67,70,0.9571428571428572
train,rolled-in_scale_48.xml,200,200,rolled-in_scale,136,29,175,74,155.5,51.5,39,45,0.8666666666666667
train,rolled-in_scale_48.xml,200,200,rolled-in_scale,110,62,200,135,155.0,98.5,90,73,1.2328767123287672
train,rolled-in_scale_49.xml,200,200,rolled-in_scale,14,65,153,123,83.5,94.0,139,58,2.396551724137931
train,rolled-in_scale_49.xml,200,200,rolled-in_scale,84,24,119,62,101.5,43.0,35,38,0.9210526315789473
train,rolled-in_scale_49.xml,200,200,rolled-in_scale,37,125,150,187,93.5,156.0,113,62,1.8225806451612903
train,rolled-in_scale_5.xml,200,200,rolled-in_scale,32,102,120,189,76.0,145.5,88,87,1.0114942528735633
train,rolled-in_scale_5.xml,200,200,rolled-in_scale,52,25,105,92,78.5,58.5,53,67,0.7910447761194029
train,rolled-in_scale_50.xml,200,200,rolled-in_scale,73,60,163,127,118.0,93.5,90,67,1.3432835820895523
train,rolled-in_scale_50.xml,200,200,rolled-in_scale,59,1,158,58,108.5,29.5,99,57,1.736842105263158
train,rolled-in_scale_50.xml,200,200,rolled-in_scale,2,3,52,53,27.0,28.0,50,50,1.0
train,rolled-in_scale_50.xml,200,200,rolled-in_scale,89,162,139,199,114.0,180.5,50,37,1.3513513513513513
train,rolled-in_scale_51.xml,200,200,rolled-in_scale,132,3,200,86,166.0,44.5,68,83,0.8192771084337349
train,rolled-in_scale_51.xml,200,200,rolled-in_scale,1,161,81,200,41.0,180.5,80,39,2.051282051282051
train,rolled-in_scale_51.xml,200,200,rolled-in_scale,133,126,199,156,166.0,141.0,66,30,2.2
train,rolled-in_scale_52.xml,200,200,rolled-in_scale,159,7,200,83,179.5,45.0,41,76,0.5394736842105263
train,rolled-in_scale_52.xml,200,200,rolled-in_scale,24,84,124,140,74.0,112.0,100,56,1.7857142857142858
train,rolled-in_scale_52.xml,200,200,rolled-in_scale,140,80,199,197,169.5,138.5,59,117,0.5042735042735043
train,rolled-in_scale_53.xml,200,200,rolled-in_scale,130,36,187,177,158.5,106.5,57,141,0.40425531914893614
train,rolled-in_scale_53.xml,200,200,rolled-in_scale,117,1,194,33,155.5,17.0,77,32,2.40625
train,rolled-in_scale_54.xml,200,200,rolled-in_scale,74,14,138,179,106.0,96.5,64,165,0.3878787878787879
train,rolled-in_scale_55.xml,200,200,rolled-in_scale,6,22,66,177,36.0,99.5,60,155,0.3870967741935484
train,rolled-in_scale_55.xml,200,200,rolled-in_scale,145,12,175,60,160.0,36.0,30,48,0.625
train,rolled-in_scale_56.xml,200,200,rolled-in_scale,87,13,152,68,119.5,40.5,65,55,1.1818181818181819
train,rolled-in_scale_56.xml,200,200,rolled-in_scale,82,122,148,182,115.0,152.0,66,60,1.1
train,rolled-in_scale_57.xml,200,200,rolled-in_scale,29,145,196,194,112.5,169.5,167,49,3.4081632653061225
train,rolled-in_scale_57.xml,200,200,rolled-in_scale,46,42,83,126,64.5,84.0,37,84,0.44047619047619047
train,rolled-in_scale_58.xml,200,200,rolled-in_scale,84,57,132,184,108.0,120.5,48,127,0.3779527559055118
train,rolled-in_scale_59.xml,200,200,rolled-in_scale,76,56,175,158,125.5,107.0,99,102,0.9705882352941176
train,rolled-in_scale_6.xml,200,200,rolled-in_scale,23,15,114,94,68.5,54.5,91,79,1.1518987341772151
train,rolled-in_scale_6.xml,200,200,rolled-in_scale,47,89,116,161,81.5,125.0,69,72,0.9583333333333334
train,rolled-in_scale_6.xml,200,200,rolled-in_scale,45,148,90,199,67.5,173.5,45,51,0.8823529411764706
train,rolled-in_scale_60.xml,200,200,rolled-in_scale,42,10,155,107,98.5,58.5,113,97,1.1649484536082475
train,rolled-in_scale_60.xml,200,200,rolled-in_scale,53,145,134,200,93.5,172.5,81,55,1.4727272727272727
train,rolled-in_scale_61.xml,200,200,rolled-in_scale,74,56,138,199,106.0,127.5,64,143,0.44755244755244755
train,rolled-in_scale_62.xml,200,200,rolled-in_scale,94,60,148,121,121.0,90.5,54,61,0.8852459016393442
train,rolled-in_scale_62.xml,200,200,rolled-in_scale,128,1,173,27,150.5,14.0,45,26,1.7307692307692308
train,rolled-in_scale_62.xml,200,200,rolled-in_scale,132,147,181,200,156.5,173.5,49,53,0.9245283018867925
train,rolled-in_scale_63.xml,200,200,rolled-in_scale,54,9,108,66,81.0,37.5,54,57,0.9473684210526315
train,rolled-in_scale_63.xml,200,200,rolled-in_scale,100,69,158,148,129.0,108.5,58,79,0.7341772151898734
train,rolled-in_scale_64.xml,200,200,rolled-in_scale,86,1,198,64,142.0,32.5,112,63,1.7777777777777777
train,rolled-in_scale_64.xml,200,200,rolled-in_scale,90,92,167,147,128.5,119.5,77,55,1.4
train,rolled-in_scale_65.xml,200,200,rolled-in_scale,48,1,157,67,102.5,34.0,109,66,1.6515151515151516
train,rolled-in_scale_65.xml,200,200,rolled-in_scale,46,88,132,150,89.0,119.0,86,62,1.3870967741935485
train,rolled-in_scale_66.xml,200,200,rolled-in_scale,1,3,102,69,51.5,36.0,101,66,1.5303030303030303
train,rolled-in_scale_66.xml,200,200,rolled-in_scale,1,88,70,145,35.5,116.5,69,57,1.2105263157894737
train,rolled-in_scale_67.xml,200,200,rolled-in_scale,47,47,124,103,85.5,75.0,77,56,1.375
train,rolled-in_scale_67.xml,200,200,rolled-in_scale,32,1,162,35,97.0,18.0,130,34,3.823529411764706
train,rolled-in_scale_67.xml,200,200,rolled-in_scale,166,152,198,198,182.0,175.0,32,46,0.6956521739130435
train,rolled-in_scale_68.xml,200,200,rolled-in_scale,82,113,200,200,141.0,156.5,118,87,1.3563218390804597
train,rolled-in_scale_69.xml,200,200,rolled-in_scale,32,91,157,186,94.5,138.5,125,95,1.3157894736842106
train,rolled-in_scale_69.xml,200,200,rolled-in_scale,48,177,164,200,106.0,188.5,116,23,5.043478260869565
train,rolled-in_scale_7.xml,200,200,rolled-in_scale,68,86,127,160,97.5,123.0,59,74,0.7972972972972973
train,rolled-in_scale_7.xml,200,200,rolled-in_scale,95,62,139,82,117.0,72.0,44,20,2.2
train,rolled-in_scale_70.xml,200,200,rolled-in_scale,2,76,103,200,52.5,138.0,101,124,0.8145161290322581
train,rolled-in_scale_70.xml,200,200,rolled-in_scale,141,169,197,195,169.0,182.0,56,26,2.1538461538461537
train,rolled-in_scale_71.xml,200,200,rolled-in_scale,81,1,187,82,134.0,41.5,106,81,1.308641975308642
train,rolled-in_scale_71.xml,200,200,rolled-in_scale,79,142,135,171,107.0,156.5,56,29,1.9310344827586208
train,rolled-in_scale_72.xml,200,200,rolled-in_scale,10,21,110,108,60.0,64.5,100,87,1.1494252873563218
train,rolled-in_scale_72.xml,200,200,rolled-in_scale,9,169,59,200,34.0,184.5,50,31,1.6129032258064515
train,rolled-in_scale_72.xml,200,200,rolled-in_scale,153,79,199,105,176.0,92.0,46,26,1.7692307692307692
train,rolled-in_scale_73.xml,200,200,rolled-in_scale,104,27,147,65,125.5,46.0,43,38,1.131578947368421
train,rolled-in_scale_73.xml,200,200,rolled-in_scale,126,83,178,181,152.0,132.0,52,98,0.5306122448979592
train,rolled-in_scale_74.xml,200,200,rolled-in_scale,61,61,108,118,84.5,89.5,47,57,0.8245614035087719
train,rolled-in_scale_74.xml,200,200,rolled-in_scale,91,110,158,184,124.5,147.0,67,74,0.9054054054054054
train,rolled-in_scale_75.xml,200,200,rolled-in_scale,44,86,172,159,108.0,122.5,128,73,1.7534246575342465
train,rolled-in_scale_75.xml,200,200,rolled-in_scale,37,11,97,97,67.0,54.0,60,86,0.6976744186046512
train,rolled-in_scale_76.xml,200,200,rolled-in_scale,94,80,199,138,146.5,109.0,105,58,1.8103448275862069
train,rolled-in_scale_76.xml,200,200,rolled-in_scale,93,9,199,71,146.0,40.0,106,62,1.7096774193548387
train,rolled-in_scale_77.xml,200,200,rolled-in_scale,91,3,159,49,125.0,26.0,68,46,1.4782608695652173
train,rolled-in_scale_77.xml,200,200,rolled-in_scale,57,71,156,198,106.5,134.5,99,127,0.7795275590551181
train,rolled-in_scale_78.xml,200,200,rolled-in_scale,83,11,179,69,131.0,40.0,96,58,1.6551724137931034
train,rolled-in_scale_78.xml,200,200,rolled-in_scale,95,80,178,197,136.5,138.5,83,117,0.7094017094017094
train,rolled-in_scale_79.xml,200,200,rolled-in_scale,30,27,138,96,84.0,61.5,108,69,1.565217391304348
train,rolled-in_scale_79.xml,200,200,rolled-in_scale,36,108,140,172,88.0,140.0,104,64,1.625
train,rolled-in_scale_8.xml,200,200,rolled-in_scale,28,124,166,186,97.0,155.0,138,62,2.225806451612903
train,rolled-in_scale_8.xml,200,200,rolled-in_scale,96,25,149,107,122.5,66.0,53,82,0.6463414634146342
train,rolled-in_scale_80.xml,200,200,rolled-in_scale,115,61,194,198,154.5,129.5,79,137,0.5766423357664233
train,rolled-in_scale_80.xml,200,200,rolled-in_scale,105,1,195,49,150.0,25.0,90,48,1.875
train,rolled-in_scale_81.xml,200,200,rolled-in_scale,65,11,146,95,105.5,53.0,81,84,0.9642857142857143
train,rolled-in_scale_81.xml,200,200,rolled-in_scale,56,104,151,172,103.5,138.0,95,68,1.3970588235294117
train,rolled-in_scale_81.xml,200,200,rolled-in_scale,21,178,117,199,69.0,188.5,96,21,4.571428571428571
train,rolled-in_scale_82.xml,200,200,rolled-in_scale,68,7,145,70,106.5,38.5,77,63,1.2222222222222223
train,rolled-in_scale_82.xml,200,200,rolled-in_scale,54,82,157,174,105.5,128.0,103,92,1.1195652173913044
train,rolled-in_scale_83.xml,200,200,rolled-in_scale,114,1,186,34,150.0,17.5,72,33,2.1818181818181817
train,rolled-in_scale_83.xml,200,200,rolled-in_scale,49,40,142,89,95.5,64.5,93,49,1.8979591836734695
train,rolled-in_scale_83.xml,200,200,rolled-in_scale,118,79,196,196,157.0,137.5,78,117,0.6666666666666666
train,rolled-in_scale_84.xml,200,200,rolled-in_scale,133,70,180,163,156.5,116.5,47,93,0.5053763440860215
train,rolled-in_scale_84.xml,200,200,rolled-in_scale,81,175,165,199,123.0,187.0,84,24,3.5
train,rolled-in_scale_85.xml,200,200,rolled-in_scale,138,10,189,65,163.5,37.5,51,55,0.9272727272727272
train,rolled-in_scale_85.xml,200,200,rolled-in_scale,130,96,186,200,158.0,148.0,56,104,0.5384615384615384
train,rolled-in_scale_86.xml,200,200,rolled-in_scale,72,14,177,65,124.5,39.5,105,51,2.0588235294117645
train,rolled-in_scale_86.xml,200,200,rolled-in_scale,61,100,180,199,120.5,149.5,119,99,1.202020202020202
train,rolled-in_scale_87.xml,200,200,rolled-in_scale,117,67,197,178,157.0,122.5,80,111,0.7207207207207207
train,rolled-in_scale_87.xml,200,200,rolled-in_scale,117,1,158,35,137.5,18.0,41,34,1.2058823529411764
train,rolled-in_scale_88.xml,200,200,rolled-in_scale,41,27,114,152,77.5,89.5,73,125,0.584
train,rolled-in_scale_88.xml,200,200,rolled-in_scale,107,40,166,166,136.5,103.0,59,126,0.46825396825396826
train,rolled-in_scale_89.xml,200,200,rolled-in_scale,9,2,93,103,51.0,52.5,84,101,0.8316831683168316
train,rolled-in_scale_89.xml,200,200,rolled-in_scale,75,1,133,113,104.0,57.0,58,112,0.5178571428571429
train,rolled-in_scale_9.xml,200,200,rolled-in_scale,74,42,174,102,124.0,72.0,100,60,1.6666666666666667
train,rolled-in_scale_90.xml,200,200,rolled-in_scale,87,1,198,48,142.5,24.5,111,47,2.3617021276595747
train,rolled-in_scale_90.xml,200,200,rolled-in_scale,74,139,199,197,136.5,168.0,125,58,2.1551724137931036
train,rolled-in_scale_91.xml,200,200,rolled-in_scale,3,111,120,187,61.5,149.0,117,76,1.5394736842105263
train,rolled-in_scale_91.xml,200,200,rolled-in_scale,26,1,138,31,82.0,16.0,112,30,3.7333333333333334
train,rolled-in_scale_92.xml,200,200,rolled-in_scale,99,32,163,180,131.0,106.0,64,148,0.43243243243243246
train,rolled-in_scale_93.xml,200,200,rolled-in_scale,84,100,163,200,123.5,150.0,79,100,0.79
train,rolled-in_scale_93.xml,200,200,rolled-in_scale,57,54,178,149,117.5,101.5,121,95,1.2736842105263158
train,rolled-in_scale_94.xml,200,200,rolled-in_scale,86,9,154,162,120.0,85.5,68,153,0.4444444444444444
train,rolled-in_scale_95.xml,200,200,rolled-in_scale,52,105,172,161,112.0,133.0,120,56,2.142857142857143
train,rolled-in_scale_95.xml,200,200,rolled-in_scale,70,16,114,36,92.0,26.0,44,20,2.2
train,rolled-in_scale_96.xml,200,200,rolled-in_scale,66,14,183,61,124.5,37.5,117,47,2.4893617021276597
train,rolled-in_scale_96.xml,200,200,rolled-in_scale,45,107,107,200,76.0,153.5,62,93,0.6666666666666666
train,rolled-in_scale_97.xml,200,200,rolled-in_scale,62,134,151,186,106.5,160.0,89,52,1.7115384615384615
train,rolled-in_scale_97.xml,200,200,rolled-in_scale,81,12,140,103,110.5,57.5,59,91,0.6483516483516484
train,rolled-in_scale_98.xml,200,200,rolled-in_scale,9,12,84,93,46.5,52.5,75,81,0.9259259259259259
train,rolled-in_scale_98.xml,200,200,rolled-in_scale,122,49,196,200,159.0,124.5,74,151,0.4900662251655629
train,rolled-in_scale_98.xml,200,200,rolled-in_scale,17,160,82,196,49.5,178.0,65,36,1.8055555555555556
train,rolled-in_scale_99.xml,200,200,rolled-in_scale,21,77,68,117,44.5,97.0,47,40,1.175
train,rolled-in_scale_99.xml,200,200,rolled-in_scale,125,33,195,196,160.0,114.5,70,163,0.4294478527607362
train,scratches_1.xml,200,200,scratches,26,12,43,171,34.5,91.5,17,159,0.1069182389937107
train,scratches_10.xml,200,200,scratches,74,1,119,124,96.5,62.5,45,123,0.36585365853658536
train,scratches_10.xml,200,200,scratches,139,1,154,196,146.5,98.5,15,195,0.07692307692307693
train,scratches_10.xml,200,200,scratches,84,77,111,150,97.5,113.5,27,73,0.3698630136986301
train,scratches_100.xml,200,200,scratches,1,94,200,122,100.5,108.0,199,28,7.107142857142857
train,scratches_101.xml,200,200,scratches,1,67,199,96,100.0,81.5,198,29,6.827586206896552
train,scratches_102.xml,200,200,scratches,1,61,200,89,100.5,75.0,199,28,7.107142857142857
train,scratches_103.xml,200,200,scratches,1,84,172,109,86.5,96.5,171,25,6.84
train,scratches_104.xml,200,200,scratches,1,22,199,54,100.0,38.0,198,32,6.1875
train,scratches_105.xml,200,200,scratches,1,32,199,58,100.0,45.0,198,26,7.615384615384615
train,scratches_106.xml,200,200,scratches,2,27,199,53,100.5,40.0,197,26,7.576923076923077
train,scratches_107.xml,200,200,scratches,1,22,199,50,100.0,36.0,198,28,7.071428571428571
train,scratches_108.xml,200,200,scratches,42,1,76,199,59.0,100.0,34,198,0.1717171717171717
train,scratches_108.xml,200,200,inclusion,133,129,150,193,141.5,161.0,17,64,0.265625
train,scratches_108.xml,200,200,inclusion,159,134,178,184,168.5,159.0,19,50,0.38
train,scratches_108.xml,200,200,inclusion,7,145,20,179,13.5,162.0,13,34,0.38235294117647056
train,scratches_109.xml,200,200,scratches,120,1,155,199,137.5,100.0,35,198,0.17676767676767677
train,scratches_109.xml,200,200,inclusion,22,102,38,177,30.0,139.5,16,75,0.21333333333333335
train,scratches_109.xml,200,200,inclusion,69,29,82,65,75.5,47.0,13,36,0.3611111111111111
train,scratches_109.xml,200,200,inclusion,83,139,95,178,89.0,158.5,12,39,0.3076923076923077
train,scratches_11.xml,200,200,scratches,5,1,43,147,24.0,74.0,38,146,0.2602739726027397
train,scratches_11.xml,200,200,scratches,64,13,81,199,72.5,106.0,17,186,0.0913978494623656
train,scratches_110.xml,200,200,scratches,16,1,61,198,38.5,99.5,45,197,0.22842639593908629
train,scratches_110.xml,200,200,inclusion,108,19,126,105,117.0,62.0,18,86,0.20930232558139536
train,scratches_110.xml,200,200,inclusion,134,26,153,70,143.5,48.0,19,44,0.4318181818181818
train,scratches_111.xml,200,200,scratches,50,1,95,199,72.5,100.0,45,198,0.22727272727272727
train,scratches_111.xml,200,200,inclusion,18,1,29,27,23.5,14.0,11,26,0.4230769230769231
train,scratches_111.xml,200,200,inclusion,144,1,161,71,152.5,36.0,17,70,0.24285714285714285
train,scratches_111.xml,200,200,inclusion,170,1,187,39,178.5,20.0,17,38,0.4473684210526316
train,scratches_112.xml,200,200,scratches,1,1,39,199,20.0,100.0,38,198,0.1919191919191919
train,scratches_113.xml,200,200,scratches,69,1,97,199,83.0,100.0,28,198,0.1414141414141414
train,scratches_113.xml,200,200,scratches,53,1,69,200,61.0,100.5,16,199,0.08040201005025126
train,scratches_113.xml,200,200,inclusion,161,170,172,193,166.5,181.5,11,23,0.4782608695652174
train,scratches_114.xml,200,200,scratches,133,1,144,199,138.5,100.0,11,198,0.05555555555555555
train,scratches_114.xml,200,200,scratches,46,91,59,200,52.5,145.5,13,109,0.11926605504587157
train,scratches_114.xml,200,200,scratches,142,1,178,199,160.0,100.0,36,198,0.18181818181818182
train,scratches_115.xml,200,200,scratches,47,1,75,199,61.0,100.0,28,198,0.1414141414141414
train,scratches_115.xml,200,200,scratches,29,1,44,199,36.5,100.0,15,198,0.07575757575757576
train,scratches_115.xml,200,200,inclusion,138,86,151,121,144.5,103.5,13,35,0.37142857142857144
train,scratches_116.xml,200,200,scratches,84,1,95,199,89.5,100.0,11,198,0.05555555555555555
train,scratches_116.xml,200,200,scratches,104,1,131,199,117.5,100.0,27,198,0.13636363636363635
train,scratches_117.xml,200,200,scratches,24,40,34,199,29.0,119.5,10,159,0.06289308176100629
train,scratches_117.xml,200,200,scratches,108,1,122,199,115.0,100.0,14,198,0.0707070707070707
train,scratches_117.xml,200,200,scratches,129,1,154,199,141.5,100.0,25,198,0.12626262626262627
train,scratches_118.xml,200,200,scratches,45,1,58,184,51.5,92.5,13,183,0.07103825136612021
train,scratches_118.xml,200,200,scratches,64,1,92,200,78.0,100.5,28,199,0.1407035175879397
train,scratches_118.xml,200,200,inclusion,172,116,185,150,178.5,133.0,13,34,0.38235294117647056
train,scratches_119.xml,200,200,scratches,82,1,93,188,87.5,94.5,11,187,0.058823529411764705
train,scratches_119.xml,200,200,scratches,99,1,132,200,115.5,100.5,33,199,0.1658291457286432
train,scratches_12.xml,200,200,scratches,20,61,35,185,27.5,123.0,15,124,0.12096774193548387
train,scratches_12.xml,200,200,scratches,23,1,36,46,29.5,23.5,13,45,0.28888888888888886
train,scratches_120.xml,200,200,scratches,102,1,134,199,118.0,100.0,32,198,0.16161616161616163
train,scratches_120.xml,200,200,inclusion,11,118,22,149,16.5,133.5,11,31,0.3548387096774194
train,scratches_121.xml,200,200,scratches,11,1,42,199,26.5,100.0,31,198,0.15656565656565657
train,scratches_121.xml,200,200,scratches,139,7,164,143,151.5,75.0,25,136,0.18382352941176472
train,scratches_121.xml,200,200,inclusion,170,16,199,109,184.5,62.5,29,93,0.3118279569892473
train,scratches_122.xml,200,200,scratches,16,1,64,198,40.0,99.5,48,197,0.2436548223350254
train,scratches_122.xml,200,200,inclusion,171,137,196,170,183.5,153.5,25,33,0.7575757575757576
train,scratches_123.xml,200,200,scratches,81,1,129,159,105.0,80.0,48,158,0.3037974683544304
train,scratches_123.xml,200,200,scratches,55,1,67,164,61.0,82.5,12,163,0.0736196319018405
train,scratches_123.xml,200,200,scratches,27,1,43,163,35.0,82.0,16,162,0.09876543209876543
train,scratches_124.xml,200,200,scratches,53,1,67,93,60.0,47.0,14,92,0.15217391304347827
train,scratches_124.xml,200,200,scratches,145,1,155,69,150.0,35.0,10,68,0.14705882352941177
train,scratches_125.xml,200,200,scratches,20,52,196,156,108.0,104.0,176,104,1.6923076923076923
train,scratches_126.xml,200,200,scratches,4,14,186,96,95.0,55.0,182,82,2.2195121951219514
train,scratches_127.xml,200,200,scratches,123,1,143,198,133.0,99.5,20,197,0.10152284263959391
train,scratches_127.xml,200,200,inclusion,165,1,200,200,182.5,100.5,35,199,0.17587939698492464
train,scratches_128.xml,200,200,scratches,45,1,66,194,55.5,97.5,21,193,0.10880829015544041
train,scratches_128.xml,200,200,inclusion,83,1,185,196,134.0,98.5,102,195,0.5230769230769231
train,scratches_129.xml,200,200,scratches,88,1,108,199,98.0,100.0,20,198,0.10101010101010101
train,scratches_129.xml,200,200,inclusion,126,1,198,197,162.0,99.0,72,196,0.3673469387755102
train,scratches_13.xml,200,200,scratches,94,57,110,86,102.0,71.5,16,29,0.5517241379310345
train,scratches_13.xml,200,200,scratches,173,110,197,197,185.0,153.5,24,87,0.27586206896551724
train,scratches_130.xml,200,200,scratches,54,15,71,198,62.5,106.5,17,183,0.09289617486338798
train,scratches_130.xml,200,200,inclusion,96,1,175,197,135.5,99.0,79,196,0.4030612244897959
train,scratches_130.xml,200,200,inclusion,15,24,45,101,30.0,62.5,30,77,0.38961038961038963
train,scratches_131.xml,200,200,scratches,67,12,94,156,80.5,84.0,27,144,0.1875
train,scratches_131.xml,200,200,scratches,140,6,155,198,147.5,102.0,15,192,0.078125
train,scratches_131.xml,200,200,inclusion,98,34,129,107,113.5,70.5,31,73,0.4246575342465753
train,scratches_131.xml,200,200,inclusion,171,34,200,200,185.5,117.0,29,166,0.1746987951807229
train,scratches_132.xml,200,200,scratches,103,1,120,96,111.5,48.5,17,95,0.17894736842105263
train,scratches_132.xml,200,200,scratches,2,100,196,194,99.0,147.0,194,94,2.0638297872340425
train,scratches_132.xml,200,200,inclusion,133,1,200,198,166.5,99.5,67,197,0.3401015228426396
train,scratches_133.xml,200,200,scratches,62,1,107,199,84.5,100.0,45,198,0.22727272727272727
train,scratches_134.xml,200,200,scratches,25,1,68,198,46.5,99.5,43,197,0.2182741116751269
train,scratches_135.xml,200,200,scratches,128,1,166,199,147.0,100.0,38,198,0.1919191919191919
train,scratches_135.xml,200,200,inclusion,35,28,51,63,43.0,45.5,16,35,0.45714285714285713
train,scratches_136.xml,200,200,scratches,49,1,87,199,68.0,100.0,38,198,0.1919191919191919
train,scratches_137.xml,200,200,scratches,89,1,125,197,107.0,99.0,36,196,0.1836734693877551
train,scratches_137.xml,200,200,inclusion,38,124,52,164,45.0,144.0,14,40,0.35
train,scratches_138.xml,200,200,scratches,143,1,178,199,160.5,100.0,35,198,0.17676767676767677
train,scratches_138.xml,200,200,inclusion,92,120,105,158,98.5,139.0,13,38,0.34210526315789475
train,scratches_139.xml,200,200,scratches,17,1,55,199,36.0,100.0,38,198,0.1919191919191919
train,scratches_139.xml,200,200,inclusion,107,112,127,200,117.0,156.0,20,88,0.22727272727272727
train,scratches_139.xml,200,200,inclusion,133,116,153,173,143.0,144.5,20,57,0.3508771929824561
train,scratches_14.xml,200,200,scratches,32,15,47,43,39.5,29.0,15,28,0.5357142857142857
train,scratches_14.xml,200,200,scratches,111,58,142,153,126.5,105.5,31,95,0.3263157894736842
train,scratches_140.xml,200,200,scratches,87,1,128,199,107.5,100.0,41,198,0.20707070707070707
train,scratches_140.xml,200,200,inclusion,52,83,66,120,59.0,101.5,14,37,0.3783783783783784
train,scratches_140.xml,200,200,inclusion,19,112,39,189,29.0,150.5,20,77,0.2597402597402597
train,scratches_140.xml,200,200,inclusion,179,71,195,156,187.0,113.5,16,85,0.18823529411764706
train,scratches_141.xml,200,200,scratches,132,1,178,199,155.0,100.0,46,198,0.23232323232323232
train,scratches_141.xml,200,200,inclusion,62,50,85,116,73.5,83.0,23,66,0.3484848484848485
train,scratches_141.xml,200,200,inclusion,96,17,108,50,102.0,33.5,12,33,0.36363636363636365
train,scratches_141.xml,200,200,inclusion,38,1,58,49,48.0,25.0,20,48,0.4166666666666667
train,scratches_141.xml,200,200,inclusion,18,64,45,109,31.5,86.5,27,45,0.6
train,scratches_142.xml,200,200,scratches,81,1,97,198,89.0,99.5,16,197,0.08121827411167512
train,scratches_142.xml,200,200,scratches,92,1,127,199,109.5,100.0,35,198,0.17676767676767677
train,scratches_143.xml,200,200,scratches,14,1,28,199,21.0,100.0,14,198,0.0707070707070707
train,scratches_143.xml,200,200,scratches,33,1,60,199,46.5,100.0,27,198,0.13636363636363635
train,scratches_144.xml,200,200,scratches,49,73,62,198,55.5,135.5,13,125,0.104
train,scratches_144.xml,200,200,scratches,132,1,148,199,140.0,100.0,16,198,0.08080808080808081
train,scratches_144.xml,200,200,scratches,154,1,178,199,166.0,100.0,24,198,0.12121212121212122
train,scratches_145.xml,200,200,scratches,73,1,89,199,81.0,100.0,16,198,0.08080808080808081
train,scratches_145.xml,200,200,scratches,94,1,121,200,107.5,100.5,27,199,0.135678391959799
train,scratches_146.xml,200,200,scratches,47,1,60,150,53.5,75.5,13,149,0.087248322147651
train,scratches_146.xml,200,200,scratches,66,1,95,199,80.5,100.0,29,198,0.14646464646464646
train,scratches_146.xml,200,200,inclusion,176,82,188,111,182.0,96.5,12,29,0.41379310344827586
train,scratches_147.xml,200,200,scratches,67,1,78,131,72.5,66.0,11,130,0.08461538461538462
train,scratches_147.xml,200,200,scratches,81,1,115,199,98.0,100.0,34,198,0.1717171717171717
train,scratches_148.xml,200,200,scratches,129,1,144,150,136.5,75.5,15,149,0.10067114093959731
train,scratches_148.xml,200,200,scratches,149,1,182,199,165.5,100.0,33,198,0.16666666666666666
train,scratches_149.xml,200,200,scratches,74,1,121,195,97.5,98.0,47,194,0.2422680412371134
train,scratches_15.xml,200,200,scratches,36,36,67,107,51.5,71.5,31,71,0.43661971830985913
train,scratches_15.xml,200,200,scratches,125,28,136,68,130.5,48.0,11,40,0.275
train,scratches_15.xml,200,200,scratches,119,127,133,198,126.0,162.5,14,71,0.19718309859154928
train,scratches_15.xml,200,200,scratches,46,77,63,127,54.5,102.0,17,50,0.34
train,scratches_150.xml,200,200,scratches,126,1,144,199,135.0,100.0,18,198,0.09090909090909091
train,scratches_151.xml,200,200,scratches,15,113,31,200,23.0,156.5,16,87,0.1839080459770115
train,scratches_151.xml,200,200,scratches,97,1,124,199,110.5,100.0,27,198,0.13636363636363635
train,scratches_152.xml,200,200,scratches,26,1,53,200,39.5,100.5,27,199,0.135678391959799
train,scratches_153.xml,200,200,scratches,114,106,127,199,120.5,152.5,13,93,0.13978494623655913
train,scratches_153.xml,200,200,scratches,83,108,96,198,89.5,153.0,13,90,0.14444444444444443
train,scratches_154.xml,200,200,scratches,56,97,77,200,66.5,148.5,21,103,0.20388349514563106
train,scratches_154.xml,200,200,scratches,98,14,115,105,106.5,59.5,17,91,0.18681318681318682
train,scratches_154.xml,200,200,scratches,126,10,148,186,137.0,98.0,22,176,0.125
train,scratches_155.xml,200,200,scratches,26,32,41,124,33.5,78.0,15,92,0.16304347826086957
train,scratches_155.xml,200,200,scratches,56,26,73,199,64.5,112.5,17,173,0.09826589595375723
train,scratches_155.xml,200,200,scratches,133,1,163,199,148.0,100.0,30,198,0.15151515151515152
train,scratches_156.xml,200,200,scratches,46,1,81,200,63.5,100.5,35,199,0.17587939698492464
train,scratches_156.xml,200,200,scratches,102,65,117,200,109.5,132.5,15,135,0.1111111111111111
train,scratches_157.xml,200,200,scratches,46,1,79,199,62.5,100.0,33,198,0.16666666666666666
train,scratches_157.xml,200,200,scratches,99,1,115,199,107.0,100.0,16,198,0.08080808080808081
train,scratches_158.xml,200,200,scratches,46,1,67,199,56.5,100.0,21,198,0.10606060606060606
train,scratches_158.xml,200,200,scratches,87,70,104,200,95.5,135.0,17,130,0.13076923076923078
train,scratches_158.xml,200,200,scratches,118,1,135,160,126.5,80.5,17,159,0.1069182389937107
train,scratches_159.xml,200,200,scratches,127,1,158,182,142.5,91.5,31,181,0.1712707182320442
train,scratches_159.xml,200,200,scratches,168,1,190,134,179.0,67.5,22,133,0.16541353383458646
train,scratches_16.xml,200,200,scratches,31,30,42,66,36.5,48.0,11,36,0.3055555555555556
train,scratches_16.xml,200,200,scratches,25,126,41,199,33.0,162.5,16,73,0.2191780821917808
train,scratches_160.xml,200,200,scratches,30,1,66,133,48.0,67.0,36,132,0.2727272727272727
train,scratches_160.xml,200,200,scratches,71,1,101,105,86.0,53.0,30,104,0.28846153846153844
train,scratches_160.xml,200,200,scratches,94,78,113,200,103.5,139.0,19,122,0.1557377049180328
train,scratches_161.xml,200,200,scratches,40,1,57,137,48.5,69.0,17,136,0.125
train,scratches_161.xml,200,200,scratches,131,27,160,200,145.5,113.5,29,173,0.1676300578034682
train,scratches_162.xml,200,200,scratches,34,1,62,198,48.0,99.5,28,197,0.14213197969543148
train,scratches_162.xml,200,200,scratches,77,28,108,187,92.5,107.5,31,159,0.1949685534591195
train,scratches_163.xml,200,200,scratches,1,1,17,198,9.0,99.5,16,197,0.08121827411167512
train,scratches_163.xml,200,200,scratches,39,77,52,199,45.5,138.0,13,122,0.10655737704918032
train,scratches_163.xml,200,200,scratches,71,1,86,165,78.5,83.0,15,164,0.09146341463414634
train,scratches_163.xml,200,200,scratches,149,2,182,198,165.5,100.0,33,196,0.1683673469387755
train,scratches_164.xml,200,200,scratches,14,10,29,183,21.5,96.5,15,173,0.08670520231213873
train,scratches_164.xml,200,200,scratches,88,1,127,197,107.5,99.0,39,196,0.1989795918367347
train,scratches_164.xml,200,200,scratches,140,1,161,196,150.5,98.5,21,195,0.1076923076923077
train,scratches_165.xml,200,200,scratches,61,1,97,166,79.0,83.5,36,165,0.21818181818181817
train,scratches_165.xml,200,200,scratches,109,1,129,198,119.0,99.5,20,197,0.10152284263959391
train,scratches_166.xml,200,200,scratches,24,1,56,199,40.0,100.0,32,198,0.16161616161616163
train,scratches_166.xml,200,200,scratches,75,1,94,199,84.5,100.0,19,198,0.09595959595959595
train,scratches_166.xml,200,200,scratches,160,107,171,198,165.5,152.5,11,91,0.12087912087912088
train,scratches_166.xml,200,200,scratches,180,1,193,99,186.5,50.0,13,98,0.1326530612244898
train,scratches_167.xml,200,200,scratches,84,1,98,197,91.0,99.0,14,196,0.07142857142857142
train,scratches_167.xml,200,200,scratches,128,1,144,198,136.0,99.5,16,197,0.08121827411167512
train,scratches_168.xml,200,200,scratches,117,1,146,86,131.5,43.5,29,85,0.3411764705882353
train,scratches_168.xml,200,200,scratches,65,16,81,107,73.0,61.5,16,91,0.17582417582417584
train,scratches_168.xml,200,200,scratches,54,129,101,198,77.5,163.5,47,69,0.6811594202898551
train,scratches_169.xml,200,200,scratches,128,4,147,199,137.5,101.5,19,195,0.09743589743589744
train,scratches_17.xml,200,200,scratches,153,87,167,176,160.0,131.5,14,89,0.15730337078651685
train,scratches_170.xml,200,200,scratches,88,1,106,200,97.0,100.5,18,199,0.09045226130653267
train,scratches_171.xml,200,200,scratches,85,1,100,97,92.5,49.0,15,96,0.15625
train,scratches_171.xml,200,200,scratches,84,126,103,200,93.5,163.0,19,74,0.25675675675675674
train,scratches_172.xml,200,200,scratches,28,16,52,153,40.0,84.5,24,137,0.17518248175182483
train,scratches_172.xml,200,200,scratches,143,10,168,198,155.5,104.0,25,188,0.13297872340425532
train,scratches_173.xml,200,200,scratches,74,1,95,159,84.5,80.0,21,158,0.13291139240506328
train,scratches_174.xml,200,200,scratches,20,1,37,199,28.5,100.0,17,198,0.08585858585858586
train,scratches_174.xml,200,200,scratches,121,15,138,200,129.5,107.5,17,185,0.0918918918918919
train,scratches_174.xml,200,200,scratches,168,23,180,200,174.0,111.5,12,177,0.06779661016949153
train,scratches_175.xml,200,200,scratches,116,1,142,200,129.0,100.5,26,199,0.1306532663316583
train,scratches_175.xml,200,200,scratches,165,58,177,199,171.0,128.5,12,141,0.0851063829787234
train,scratches_176.xml,200,200,scratches,101,1,129,199,115.0,100.0,28,198,0.1414141414141414
train,scratches_176.xml,200,200,scratches,151,28,163,199,157.0,113.5,12,171,0.07017543859649122
train,scratches_177.xml,200,200,scratches,41,1,70,199,55.5,100.0,29,198,0.14646464646464646
train,scratches_177.xml,200,200,scratches,91,1,106,199,98.5,100.0,15,198,0.07575757575757576
train,scratches_178.xml,200,200,scratches,93,1,120,199,106.5,100.0,27,198,0.13636363636363635
train,scratches_179.xml,200,200,scratches,56,1,88,199,72.0,100.0,32,198,0.16161616161616163
train,scratches_18.xml,200,200,scratches,46,22,58,128,52.0,75.0,12,106,0.11320754716981132
train,scratches_180.xml,200,200,scratches,129,1,160,199,144.5,100.0,31,198,0.15656565656565657
train,scratches_181.xml,200,200,scratches,85,1,116,199,100.5,100.0,31,198,0.15656565656565657
train,scratches_182.xml,200,200,scratches,54,1,86,199,70.0,100.0,32,198,0.16161616161616163
train,scratches_183.xml,200,200,scratches,32,1,62,200,47.0,100.5,30,199,0.1507537688442211
train,scratches_183.xml,200,200,scratches,174,3,191,92,182.5,47.5,17,89,0.19101123595505617
train,scratches_184.xml,200,200,scratches,146,1,173,199,159.5,100.0,27,198,0.13636363636363635
train,scratches_185.xml,200,200,scratches,89,1,116,200,102.5,100.5,27,199,0.135678391959799
train,scratches_186.xml,200,200,scratches,18,1,50,200,34.0,100.5,32,199,0.16080402010050251
train,scratches_186.xml,200,200,scratches,142,86,186,143,164.0,114.5,44,57,0.7719298245614035
train,scratches_186.xml,200,200,scratches,154,1,179,176,166.5,88.5,25,175,0.14285714285714285
train,scratches_187.xml,200,200,scratches,24,1,60,199,42.0,100.0,36,198,0.18181818181818182
train,scratches_188.xml,200,200,scratches,100,1,131,199,115.5,100.0,31,198,0.15656565656565657
train,scratches_188.xml,200,200,scratches,73,7,98,60,85.5,33.5,25,53,0.4716981132075472
train,scratches_189.xml,200,200,scratches,145,1,180,199,162.5,100.0,35,198,0.17676767676767677
train,scratches_189.xml,200,200,scratches,122,28,145,76,133.5,52.0,23,48,0.4791666666666667
train,scratches_19.xml,200,200,scratches,163,16,178,175,170.5,95.5,15,159,0.09433962264150944
train,scratches_190.xml,200,200,scratches,154,1,183,198,168.5,99.5,29,197,0.14720812182741116
train,scratches_191.xml,200,200,scratches,21,1,45,200,33.0,100.5,24,199,0.12060301507537688
train,scratches_192.xml,200,200,scratches,100,1,119,196,109.5,98.5,19,195,0.09743589743589744
train,scratches_193.xml,200,200,scratches,121,1,139,134,130.0,67.5,18,133,0.13533834586466165
train,scratches_194.xml,200,200,scratches,23,1,41,170,32.0,85.5,18,169,0.10650887573964497
train,scratches_194.xml,200,200,scratches,109,30,129,129,119.0,79.5,20,99,0.20202020202020202
train,scratches_195.xml,200,200,scratches,39,67,52,199,45.5,133.0,13,132,0.09848484848484848
train,scratches_196.xml,200,200,scratches,24,1,37,200,30.5,100.5,13,199,0.06532663316582915
train,scratches_197.xml,200,200,scratches,113,1,127,198,120.0,99.5,14,197,0.07106598984771574
train,scratches_197.xml,200,200,scratches,33,1,45,198,39.0,99.5,12,197,0.06091370558375635
train,scratches_198.xml,200,200,scratches,31,48,42,199,36.5,123.5,11,151,0.0728476821192053
train,scratches_198.xml,200,200,scratches,108,1,123,200,115.5,100.5,15,199,0.07537688442211055
train,scratches_198.xml,200,200,scratches,31,1,44,59,37.5,30.0,13,58,0.22413793103448276
train,scratches_199.xml,200,200,scratches,69,13,85,197,77.0,105.0,16,184,0.08695652173913043
train,scratches_199.xml,200,200,scratches,142,1,159,154,150.5,77.5,17,153,0.1111111111111111
train,scratches_2.xml,200,200,scratches,92,24,106,176,99.0,100.0,14,152,0.09210526315789473
train,scratches_20.xml,200,200,scratches,28,76,45,200,36.5,138.0,17,124,0.13709677419354838
train,scratches_200.xml,200,200,scratches,119,6,137,200,128.0,103.0,18,194,0.09278350515463918
train,scratches_201.xml,200,200,scratches,79,1,97,199,88.0,100.0,18,198,0.09090909090909091
train,scratches_202.xml,200,200,scratches,52,41,62,117,57.0,79.0,10,76,0.13157894736842105
train,scratches_202.xml,200,200,scratches,71,126,81,199,76.0,162.5,10,73,0.136986301369863
train,scratches_203.xml,200,200,scratches,64,2,77,200,70.5,101.0,13,198,0.06565656565656566
train,scratches_204.xml,200,200,scratches,61,1,81,196,71.0,98.5,20,195,0.10256410256410256
train,scratches_205.xml,200,200,scratches,135,29,148,196,141.5,112.5,13,167,0.07784431137724551
train,scratches_205.xml,200,200,scratches,32,1,47,177,39.5,89.0,15,176,0.08522727272727272
train,scratches_206.xml,200,200,scratches,109,3,128,130,118.5,66.5,19,127,0.14960629921259844
train,scratches_206.xml,200,200,scratches,137,50,154,198,145.5,124.0,17,148,0.11486486486486487
train,scratches_207.xml,200,200,scratches,51,1,70,82,60.5,41.5,19,81,0.2345679012345679
train,scratches_207.xml,200,200,scratches,78,2,96,199,87.0,100.5,18,197,0.09137055837563451
train,scratches_208.xml,200,200,scratches,115,1,131,196,123.0,98.5,16,195,0.08205128205128205
train,scratches_209.xml,200,200,scratches,53,1,69,132,61.0,66.5,16,131,0.12213740458015267
train,scratches_209.xml,200,200,scratches,114,1,144,147,129.0,74.0,30,146,0.2054794520547945
train,scratches_209.xml,200,200,inclusion,115,47,199,94,157.0,70.5,84,47,1.7872340425531914
train,scratches_21.xml,200,200,scratches,92,23,109,199,100.5,111.0,17,176,0.09659090909090909
train,scratches_21.xml,200,200,scratches,52,144,94,199,73.0,171.5,42,55,0.7636363636363637
train,scratches_210.xml,200,200,scratches,63,1,83,197,73.0,99.0,20,196,0.10204081632653061
train,scratches_210.xml,200,200,scratches,130,1,161,198,145.5,99.5,31,197,0.15736040609137056
train,scratches_210.xml,200,200,inclusion,145,28,200,51,172.5,39.5,55,23,2.391304347826087
train,scratches_210.xml,200,200,inclusion,137,141,200,164,168.5,152.5,63,23,2.739130434782609
train,scratches_210.xml,200,200,inclusion,163,116,200,137,181.5,126.5,37,21,1.7619047619047619
train,scratches_211.xml,200,200,scratches,64,1,80,198,72.0,99.5,16,197,0.08121827411167512
train,scratches_211.xml,200,200,scratches,138,1,170,196,154.0,98.5,32,195,0.1641025641025641
train,scratches_211.xml,200,200,inclusion,152,152,198,182,175.0,167.0,46,30,1.5333333333333334
train,scratches_212.xml,200,200,scratches,16,1,29,200,22.5,100.5,13,199,0.06532663316582915
train,scratches_212.xml,200,200,scratches,133,1,151,200,142.0,100.5,18,199,0.09045226130653267
train,scratches_213.xml,200,200,scratches,44,2,68,199,56.0,100.5,24,197,0.1218274111675127
train,scratches_213.xml,200,200,scratches,127,1,154,200,140.5,100.5,27,199,0.135678391959799
train,scratches_214.xml,200,200,scratches,14,43,32,198,23.0,120.5,18,155,0.11612903225806452
train,scratches_214.xml,200,200,scratches,128,1,154,200,141.0,100.5,26,199,0.1306532663316583
train,scratches_215.xml,200,200,scratches,28,1,53,199,40.5,100.0,25,198,0.12626262626262627
train,scratches_215.xml,200,200,scratches,114,48,141,200,127.5,124.0,27,152,0.17763157894736842
train,scratches_216.xml,200,200,scratches,14,51,32,182,23.0,116.5,18,131,0.13740458015267176
train,scratches_216.xml,200,200,scratches,42,100,65,198,53.5,149.0,23,98,0.23469387755102042
train,scratches_216.xml,200,200,scratches,155,2,182,198,168.5,100.0,27,196,0.1377551020408163
train,scratches_216.xml,200,200,inclusion,1,1,52,34,26.5,17.5,51,33,1.5454545454545454
train,scratches_217.xml,200,200,scratches,32,1,64,198,48.0,99.5,32,197,0.16243654822335024
train,scratches_217.xml,200,200,scratches,101,1,116,54,108.5,27.5,15,53,0.2830188679245283
train,scratches_217.xml,200,200,scratches,128,139,148,199,138.0,169.0,20,60,0.3333333333333333
train,scratches_218.xml,200,200,scratches,57,55,88,198,72.5,126.5,31,143,0.21678321678321677
train,scratches_218.xml,200,200,scratches,48,1,62,66,55.0,33.5,14,65,0.2153846153846154
train,scratches_218.xml,200,200,scratches,125,59,142,159,133.5,109.0,17,100,0.17
train,scratches_218.xml,200,200,scratches,12,64,26,163,19.0,113.5,14,99,0.1414141414141414
train,scratches_219.xml,200,200,scratches,83,4,99,117,91.0,60.5,16,113,0.1415929203539823
train,scratches_219.xml,200,200,scratches,160,111,178,199,169.0,155.0,18,88,0.20454545454545456
train,scratches_219.xml,200,200,scratches,48,114,62,197,55.0,155.5,14,83,0.1686746987951807
train,scratches_219.xml,200,200,scratches,107,75,129,198,118.0,136.5,22,123,0.17886178861788618
train,scratches_22.xml,200,200,scratches,21,1,34,76,27.5,38.5,13,75,0.17333333333333334
train,scratches_22.xml,200,200,scratches,19,100,33,197,26.0,148.5,14,97,0.14432989690721648
train,scratches_22.xml,200,200,scratches,1,14,23,51,12.0,32.5,22,37,0.5945945945945946
train,scratches_220.xml,200,200,scratches,141,1,165,116,153.0,58.5,24,115,0.20869565217391303
train,scratches_220.xml,200,200,scratches,105,1,135,112,120.0,56.5,30,111,0.2702702702702703
train,scratches_220.xml,200,200,scratches,79,16,93,193,86.0,104.5,14,177,0.07909604519774012
train,scratches_221.xml,200,200,scratches,17,1,47,144,32.0,72.5,30,143,0.2097902097902098
train,scratches_221.xml,200,200,scratches,156,31,174,180,165.0,105.5,18,149,0.12080536912751678
train,scratches_221.xml,200,200,scratches,85,1,110,148,97.5,74.5,25,147,0.17006802721088435
train,scratches_222.xml,200,200,scratches,39,101,58,200,48.5,150.5,19,99,0.1919191919191919
train,scratches_222.xml,200,200,scratches,98,2,117,147,107.5,74.5,19,145,0.1310344827586207
train,scratches_222.xml,200,200,scratches,28,21,45,86,36.5,53.5,17,65,0.26153846153846155
train,scratches_222.xml,200,200,inclusion,155,2,186,197,170.5,99.5,31,195,0.15897435897435896
train,scratches_223.xml,200,200,scratches,59,8,81,105,70.0,56.5,22,97,0.2268041237113402
train,scratches_223.xml,200,200,scratches,127,108,144,200,135.5,154.0,17,92,0.18478260869565216
train,scratches_224.xml,200,200,scratches,40,27,55,172,47.5,99.5,15,145,0.10344827586206896
train,scratches_224.xml,200,200,scratches,134,37,145,200,139.5,118.5,11,163,0.06748466257668712
train,scratches_224.xml,200,200,scratches,105,58,117,199,111.0,128.5,12,141,0.0851063829787234
train,scratches_225.xml,200,200,scratches,53,52,70,155,61.5,103.5,17,103,0.1650485436893204
train,scratches_225.xml,200,200,scratches,173,1,186,86,179.5,43.5,13,85,0.15294117647058825
train,scratches_225.xml,200,200,scratches,1,3,16,184,8.5,93.5,15,181,0.08287292817679558
train,scratches_225.xml,200,200,inclusion,174,179,199,200,186.5,189.5,25,21,1.1904761904761905
train,scratches_226.xml,200,200,scratches,71,11,84,199,77.5,105.0,13,188,0.06914893617021277
train,scratches_226.xml,200,200,scratches,38,4,56,184,47.0,94.0,18,180,0.1
train,scratches_226.xml,200,200,inclusion,1,100,53,164,27.0,132.0,52,64,0.8125
train,scratches_227.xml,200,200,scratches,74,33,100,200,87.0,116.5,26,167,0.15568862275449102
train,scratches_228.xml,200,200,scratches,21,7,37,200,29.0,103.5,16,193,0.08290155440414508
train,scratches_228.xml,200,200,pitted_surface,67,55,131,187,99.0,121.0,64,132,0.48484848484848486
train,scratches_228.xml,200,200,patches,167,89,200,122,183.5,105.5,33,33,1.0
train,scratches_229.xml,200,200,scratches,71,55,87,200,79.0,127.5,16,145,0.1103448275862069
train,scratches_229.xml,200,200,inclusion,95,1,114,41,104.5,21.0,19,40,0.475
train,scratches_23.xml,200,200,scratches,128,1,141,56,134.5,28.5,13,55,0.23636363636363636
train,scratches_23.xml,200,200,scratches,122,90,140,199,131.0,144.5,18,109,0.1651376146788991
train,scratches_23.xml,200,200,scratches,38,2,124,198,81.0,100.0,86,196,0.4387755102040816
train,scratches_230.xml,200,200,scratches,108,4,125,199,116.5,101.5,17,195,0.08717948717948718
train,scratches_230.xml,200,200,scratches,45,3,60,199,52.5,101.0,15,196,0.07653061224489796
train,scratches_230.xml,200,200,scratches,80,2,96,168,88.0,85.0,16,166,0.0963855421686747
train,scratches_230.xml,200,200,scratches,161,10,177,168,169.0,89.0,16,158,0.10126582278481013
train,scratches_231.xml,200,200,scratches,13,1,45,195,29.0,98.0,32,194,0.16494845360824742
train,scratches_231.xml,200,200,scratches,145,3,160,200,152.5,101.5,15,197,0.07614213197969544
train,scratches_231.xml,200,200,inclusion,12,120,100,151,56.0,135.5,88,31,2.838709677419355
train,scratches_232.xml,200,200,scratches,143,74,160,179,151.5,126.5,17,105,0.1619047619047619
train,scratches_232.xml,200,200,scratches,37,69,170,82,103.5,75.5,133,13,10.23076923076923
train,scratches_233.xml,200,200,scratches,3,61,200,80,101.5,70.5,197,19,10.368421052631579
train,scratches_233.xml,200,200,scratches,1,144,70,156,35.5,150.0,69,12,5.75
train,scratches_233.xml,200,200,inclusion,79,152,91,189,85.0,170.5,12,37,0.32432432432432434
train,scratches_234.xml,200,200,scratches,1,68,179,85,90.0,76.5,178,17,10.470588235294118
train,scratches_234.xml,200,200,scratches,15,137,198,158,106.5,147.5,183,21,8.714285714285714
train,scratches_235.xml,200,200,scratches,1,79,198,94,99.5,86.5,197,15,13.133333333333333
train,scratches_236.xml,200,200,scratches,44,90,189,106,116.5,98.0,145,16,9.0625
train,scratches_236.xml,200,200,scratches,1,117,124,135,62.5,126.0,123,18,6.833333333333333
train,scratches_236.xml,200,200,inclusion,155,25,165,110,160.0,67.5,10,85,0.11764705882352941
train,scratches_237.xml,200,200,scratches,26,158,199,176,112.5,167.0,173,18,9.61111111111111
train,scratches_237.xml,200,200,scratches,1,37,196,52,98.5,44.5,195,15,13.0
train,scratches_238.xml,200,200,scratches,1,22,112,37,56.5,29.5,111,15,7.4
train,scratches_238.xml,200,200,scratches,1,133,199,167,100.0,150.0,198,34,5.823529411764706
train,scratches_239.xml,200,200,scratches,55,152,157,169,106.0,160.5,102,17,6.0
train,scratches_239.xml,200,200,scratches,4,87,197,116,100.5,101.5,193,29,6.655172413793103
train,scratches_239.xml,200,200,scratches,152,76,200,89,176.0,82.5,48,13,3.6923076923076925
train,scratches_24.xml,200,200,scratches,17,1,56,198,36.5,99.5,39,197,0.19796954314720813
train,scratches_240.xml,200,200,scratches,53,132,199,160,126.0,146.0,146,28,5.214285714285714
train,scratches_240.xml,200,200,scratches,61,102,199,128,130.0,115.0,138,26,5.3076923076923075
train,scratches_240.xml,200,200,scratches,13,75,156,88,84.5,81.5,143,13,11.0
train,scratches_25.xml,200,200,scratches,35,1,97,198,66.0,99.5,62,197,0.3147208121827411
train,scratches_25.xml,200,200,scratches,112,5,151,198,131.5,101.5,39,193,0.20207253886010362
train,scratches_26.xml,200,200,scratches,19,1,60,133,39.5,67.0,41,132,0.3106060606060606
train,scratches_26.xml,200,200,scratches,41,149,59,199,50.0,174.0,18,50,0.36
train,scratches_27.xml,200,200,scratches,13,1,59,199,36.0,100.0,46,198,0.23232323232323232
train,scratches_27.xml,200,200,scratches,61,92,90,157,75.5,124.5,29,65,0.4461538461538462
train,scratches_27.xml,200,200,scratches,103,6,143,144,123.0,75.0,40,138,0.2898550724637681
train,scratches_27.xml,200,200,scratches,127,146,144,199,135.5,172.5,17,53,0.32075471698113206
train,scratches_28.xml,200,200,scratches,8,14,24,98,16.0,56.0,16,84,0.19047619047619047
train,scratches_28.xml,200,200,scratches,9,144,22,199,15.5,171.5,13,55,0.23636363636363636
train,scratches_29.xml,200,200,scratches,52,61,80,158,66.0,109.5,28,97,0.28865979381443296
train,scratches_29.xml,200,200,scratches,93,119,109,199,101.0,159.0,16,80,0.2
train,scratches_29.xml,200,200,scratches,94,1,111,70,102.5,35.5,17,69,0.2463768115942029
train,scratches_3.xml,200,200,scratches,148,165,176,199,162.0,182.0,28,34,0.8235294117647058
train,scratches_3.xml,200,200,scratches,167,40,179,121,173.0,80.5,12,81,0.14814814814814814
train,scratches_30.xml,200,200,scratches,14,1,34,73,24.0,37.0,20,72,0.2777777777777778
train,scratches_30.xml,200,200,scratches,61,1,77,26,69.0,13.5,16,25,0.64
train,scratches_30.xml,200,200,scratches,129,18,143,97,136.0,57.5,14,79,0.17721518987341772
train,scratches_30.xml,200,200,scratches,88,91,114,190,101.0,140.5,26,99,0.26262626262626265
train,scratches_30.xml,200,200,scratches,130,149,142,198,136.0,173.5,12,49,0.24489795918367346
train,scratches_31.xml,200,200,scratches,126,1,140,80,133.0,40.5,14,79,0.17721518987341772
train,scratches_31.xml,200,200,scratches,123,115,137,199,130.0,157.0,14,84,0.16666666666666666
train,scratches_32.xml,200,200,scratches,31,1,44,42,37.5,21.5,13,41,0.3170731707317073
train,scratches_32.xml,200,200,scratches,27,68,42,187,34.5,127.5,15,119,0.12605042016806722
train,scratches_32.xml,200,200,scratches,177,61,193,180,185.0,120.5,16,119,0.13445378151260504
train,scratches_32.xml,200,200,inclusion,105,84,120,116,112.5,100.0,15,32,0.46875
train,scratches_33.xml,200,200,scratches,107,30,124,150,115.5,90.0,17,120,0.14166666666666666
train,scratches_33.xml,200,200,inclusion,38,47,52,80,45.0,63.5,14,33,0.42424242424242425
train,scratches_34.xml,200,200,scratches,135,37,160,198,147.5,117.5,25,161,0.15527950310559005
train,scratches_35.xml,200,200,scratches,104,10,128,199,116.0,104.5,24,189,0.12698412698412698
train,scratches_36.xml,200,200,scratches,38,10,62,199,50.0,104.5,24,189,0.12698412698412698
train,scratches_37.xml,200,200,scratches,156,1,183,200,169.5,100.5,27,199,0.135678391959799
train,scratches_38.xml,200,200,scratches,96,1,122,199,109.0,100.0,26,198,0.13131313131313133
train,scratches_39.xml,200,200,scratches,12,1,39,199,25.5,100.0,27,198,0.13636363636363635
train,scratches_4.xml,200,200,scratches,157,62,199,199,178.0,130.5,42,137,0.30656934306569344
train,scratches_40.xml,200,200,scratches,121,1,144,199,132.5,100.0,23,198,0.11616161616161616
train,scratches_41.xml,200,200,scratches,28,1,55,199,41.5,100.0,27,198,0.13636363636363635
train,scratches_42.xml,200,200,scratches,93,1,122,182,107.5,91.5,29,181,0.16022099447513813
train,scratches_43.xml,200,200,scratches,79,14,95,188,87.0,101.0,16,174,0.09195402298850575
train,scratches_44.xml,200,200,scratches,93,8,111,190,102.0,99.0,18,182,0.0989010989010989
train,scratches_45.xml,200,200,scratches,1,78,199,100,100.0,89.0,198,22,9.0
train,scratches_46.xml,200,200,scratches,1,149,194,169,97.5,159.0,193,20,9.65
train,scratches_47.xml,200,200,scratches,28,44,52,199,40.0,121.5,24,155,0.15483870967741936
train,scratches_48.xml,200,200,scratches,157,44,181,198,169.0,121.0,24,154,0.15584415584415584
train,scratches_48.xml,200,200,inclusion,36,1,53,43,44.5,22.0,17,42,0.40476190476190477
train,scratches_49.xml,200,200,scratches,80,32,107,199,93.5,115.5,27,167,0.16167664670658682
train,scratches_5.xml,200,200,scratches,140,40,198,199,169.0,119.5,58,159,0.36477987421383645
train,scratches_50.xml,200,200,scratches,34,1,67,198,50.5,99.5,33,197,0.16751269035532995
train,scratches_51.xml,200,200,scratches,134,1,163,198,148.5,99.5,29,197,0.14720812182741116
train,scratches_52.xml,200,200,scratches,97,1,130,199,113.5,100.0,33,198,0.16666666666666666
train,scratches_53.xml,200,200,scratches,144,1,184,198,164.0,99.5,40,197,0.20304568527918782
train,scratches_54.xml,200,200,scratches,32,1,76,199,54.0,100.0,44,198,0.2222222222222222
train,scratches_55.xml,200,200,scratches,86,1,126,199,106.0,100.0,40,198,0.20202020202020202
train,scratches_56.xml,200,200,scratches,131,1,168,198,149.5,99.5,37,197,0.18781725888324874
train,scratches_57.xml,200,200,scratches,70,1,102,156,86.0,78.5,32,155,0.2064516129032258
train,scratches_58.xml,200,200,scratches,18,1,50,181,34.0,91.0,32,180,0.17777777777777778
train,scratches_59.xml,200,200,scratches,1,85,198,119,99.5,102.0,197,34,5.794117647058823
train,scratches_6.xml,200,200,scratches,89,17,153,198,121.0,107.5,64,181,0.35359116022099446
train,scratches_6.xml,200,200,scratches,151,46,164,137,157.5,91.5,13,91,0.14285714285714285
train,scratches_60.xml,200,200,scratches,1,165,198,195,99.5,180.0,197,30,6.566666666666666
train,scratches_61.xml,200,200,scratches,1,25,190,57,95.5,41.0,189,32,5.90625
train,scratches_62.xml,200,200,scratches,21,25,199,54,110.0,39.5,178,29,6.137931034482759
train,scratches_63.xml,200,200,scratches,1,119,177,152,89.0,135.5,176,33,5.333333333333333
train,scratches_64.xml,200,200,scratches,1,27,197,60,99.0,43.5,196,33,5.9393939393939394
train,scratches_65.xml,200,200,scratches,2,129,199,157,100.5,143.0,197,28,7.035714285714286
train,scratches_66.xml,200,200,scratches,77,1,97,198,87.0,99.5,20,197,0.10152284263959391
train,scratches_66.xml,200,200,scratches,103,1,123,198,113.0,99.5,20,197,0.10152284263959391
train,scratches_66.xml,200,200,scratches,130,13,145,120,137.5,66.5,15,107,0.14018691588785046
train,scratches_67.xml,200,200,scratches,33,1,52,198,42.5,99.5,19,197,0.09644670050761421
train,scratches_67.xml,200,200,scratches,57,23,71,198,64.0,110.5,14,175,0.08
train,scratches_68.xml,200,200,scratches,5,30,27,198,16.0,114.0,22,168,0.13095238095238096
train,scratches_68.xml,200,200,scratches,32,44,51,162,41.5,103.0,19,118,0.16101694915254236
train,scratches_68.xml,200,200,scratches,108,62,123,195,115.5,128.5,15,133,0.11278195488721804
train,scratches_69.xml,200,200,scratches,148,1,163,198,155.5,99.5,15,197,0.07614213197969544
train,scratches_69.xml,200,200,inclusion,85,18,107,105,96.0,61.5,22,87,0.25287356321839083
train,scratches_7.xml,200,200,scratches,17,3,82,198,49.5,100.5,65,195,0.3333333333333333
train,scratches_7.xml,200,200,scratches,80,40,93,110,86.5,75.0,13,70,0.18571428571428572
train,scratches_7.xml,200,200,inclusion,127,1,148,47,137.5,24.0,21,46,0.45652173913043476
train,scratches_70.xml,200,200,scratches,126,5,145,191,135.5,98.0,19,186,0.10215053763440861
train,scratches_70.xml,200,200,scratches,164,1,176,191,170.0,96.0,12,190,0.06315789473684211
train,scratches_71.xml,200,200,scratches,84,4,98,199,91.0,101.5,14,195,0.07179487179487179
train,scratches_72.xml,200,200,scratches,18,4,32,197,25.0,100.5,14,193,0.07253886010362694
train,scratches_73.xml,200,200,scratches,165,1,177,185,171.0,93.0,12,184,0.06521739130434782
train,scratches_74.xml,200,200,scratches,143,123,160,196,151.5,159.5,17,73,0.2328767123287671
train,scratches_74.xml,200,200,scratches,174,65,188,196,181.0,130.5,14,131,0.10687022900763359
train,scratches_75.xml,200,200,scratches,34,91,53,192,43.5,141.5,19,101,0.18811881188118812
train,scratches_75.xml,200,200,scratches,66,37,79,184,72.5,110.5,13,147,0.08843537414965986
train,scratches_75.xml,200,200,scratches,130,8,141,186,135.5,97.0,11,178,0.06179775280898876
train,scratches_76.xml,200,200,scratches,160,34,173,199,166.5,116.5,13,165,0.07878787878787878
train,scratches_77.xml,200,200,scratches,169,1,184,198,176.5,99.5,15,197,0.07614213197969544
train,scratches_77.xml,200,200,scratches,104,40,115,198,109.5,119.0,11,158,0.06962025316455696
train,scratches_78.xml,200,200,scratches,101,10,116,199,108.5,104.5,15,189,0.07936507936507936
train,scratches_78.xml,200,200,scratches,151,16,162,199,156.5,107.5,11,183,0.060109289617486336
train,scratches_78.xml,200,200,scratches,37,57,47,197,42.0,127.0,10,140,0.07142857142857142
train,scratches_79.xml,200,200,scratches,51,6,69,200,60.0,103.0,18,194,0.09278350515463918
train,scratches_79.xml,200,200,scratches,101,22,115,200,108.0,111.0,14,178,0.07865168539325842
train,scratches_8.xml,200,200,scratches,158,1,199,147,178.5,74.0,41,146,0.2808219178082192
train,scratches_8.xml,200,200,scratches,169,107,189,170,179.0,138.5,20,63,0.31746031746031744
train,scratches_80.xml,200,200,scratches,139,1,152,199,145.5,100.0,13,198,0.06565656565656566
train,scratches_81.xml,200,200,scratches,75,1,89,195,82.0,98.0,14,194,0.07216494845360824
train,scratches_81.xml,200,200,scratches,142,1,156,170,149.0,85.5,14,169,0.08284023668639054
train,scratches_82.xml,200,200,scratches,24,3,36,179,30.0,91.0,12,176,0.06818181818181818
train,scratches_82.xml,200,200,scratches,90,1,105,167,97.5,84.0,15,166,0.09036144578313253
train,scratches_82.xml,200,200,scratches,140,1,151,176,145.5,88.5,11,175,0.06285714285714286
train,scratches_83.xml,200,200,scratches,23,1,37,128,30.0,64.5,14,127,0.11023622047244094
train,scratches_83.xml,200,200,scratches,74,1,84,141,79.0,71.0,10,140,0.07142857142857142
train,scratches_84.xml,200,200,scratches,142,19,153,196,147.5,107.5,11,177,0.062146892655367235
train,scratches_85.xml,200,200,scratches,103,15,118,197,110.5,106.0,15,182,0.08241758241758242
train,scratches_85.xml,200,200,scratches,172,33,180,198,176.0,115.5,8,165,0.048484848484848485
train,scratches_86.xml,200,200,scratches,40,12,52,199,46.0,105.5,12,187,0.06417112299465241
train,scratches_86.xml,200,200,scratches,104,17,116,198,110.0,107.5,12,181,0.06629834254143646
train,scratches_86.xml,200,200,scratches,138,35,147,198,142.5,116.5,9,163,0.05521472392638037
train,scratches_87.xml,200,200,scratches,150,1,164,193,157.0,97.0,14,192,0.07291666666666667
train,scratches_88.xml,200,200,scratches,103,1,116,186,109.5,93.5,13,185,0.07027027027027027
train,scratches_88.xml,200,200,scratches,172,1,181,193,176.5,97.0,9,192,0.046875
train,scratches_89.xml,200,200,scratches,65,4,76,175,70.5,89.5,11,171,0.06432748538011696
train,scratches_9.xml,200,200,scratches,132,1,180,170,156.0,85.5,48,169,0.28402366863905326
train,scratches_9.xml,200,200,scratches,142,121,164,199,153.0,160.0,22,78,0.28205128205128205
train,scratches_90.xml,200,200,scratches,170,52,191,199,180.5,125.5,21,147,0.14285714285714285
train,scratches_91.xml,200,200,scratches,84,19,107,199,95.5,109.0,23,180,0.12777777777777777
train,scratches_92.xml,200,200,scratches,35,2,52,199,43.5,100.5,17,197,0.08629441624365482
train,scratches_92.xml,200,200,scratches,60,31,90,192,75.0,111.5,30,161,0.18633540372670807
train,scratches_92.xml,200,200,inclusion,173,169,190,200,181.5,184.5,17,31,0.5483870967741935
train,scratches_93.xml,200,200,scratches,28,88,41,197,34.5,142.5,13,109,0.11926605504587157
train,scratches_93.xml,200,200,scratches,61,52,80,196,70.5,124.0,19,144,0.13194444444444445
train,scratches_94.xml,200,200,scratches,93,1,115,199,104.0,100.0,22,198,0.1111111111111111
train,scratches_94.xml,200,200,scratches,22,97,42,199,32.0,148.0,20,102,0.19607843137254902
train,scratches_94.xml,200,200,scratches,120,35,145,173,132.5,104.0,25,138,0.18115942028985507
train,scratches_94.xml,200,200,inclusion,71,95,85,121,78.0,108.0,14,26,0.5384615384615384
train,scratches_94.xml,200,200,inclusion,72,144,84,172,78.0,158.0,12,28,0.42857142857142855
train,scratches_95.xml,200,200,scratches,21,36,35,198,28.0,117.0,14,162,0.08641975308641975
train,scratches_96.xml,200,200,scratches,154,1,177,150,165.5,75.5,23,149,0.15436241610738255
train,scratches_97.xml,200,200,scratches,79,49,93,200,86.0,124.5,14,151,0.09271523178807947
train,scratches_97.xml,200,200,scratches,112,9,129,194,120.5,101.5,17,185,0.0918918918918919
train,scratches_97.xml,200,200,inclusion,42,97,56,142,49.0,119.5,14,45,0.3111111111111111
train,scratches_98.xml,200,200,scratches,6,130,199,146,102.5,138.0,193,16,12.0625
train,scratches_99.xml,200,200,scratches,1,136,199,163,100.0,149.5,198,27,7.333333333333333
train,crazing_240.xml,200,200,crazing,12,2,176,58,94.0,30.0,164,56,2.9285714285714284
train,crazing_240.xml,200,200,crazing,71,84,200,172,135.5,128.0,129,88,1.4659090909090908
train,crazing_240.xml,200,200,crazing,47,140,200,200,123.5,170.0,153,60,2.55
validation,crazing_241.xml,200,200,crazing,42,124,183,184,112.5,154.0,141,60,2.35
validation,crazing_241.xml,200,200,crazing,38,9,188,84,113.0,46.5,150,75,2.0
validation,crazing_241.xml,200,200,crazing,1,65,172,156,86.5,110.5,171,91,1.879120879120879
validation,crazing_242.xml,200,200,crazing,36,4,184,55,110.0,29.5,148,51,2.9019607843137254
validation,crazing_242.xml,200,200,crazing,64,76,181,168,122.5,122.0,117,92,1.2717391304347827
validation,crazing_242.xml,200,200,crazing,17,128,196,199,106.5,163.5,179,71,2.5211267605633805
validation,crazing_243.xml,200,200,crazing,9,143,115,198,62.0,170.5,106,55,1.9272727272727272
validation,crazing_243.xml,200,200,crazing,1,38,93,127,47.0,82.5,92,89,1.0337078651685394
validation,crazing_243.xml,200,200,crazing,112,47,187,142,149.5,94.5,75,95,0.7894736842105263
validation,crazing_243.xml,200,200,crazing,42,1,162,42,102.0,21.5,120,41,2.926829268292683
validation,crazing_244.xml,200,200,crazing,1,57,192,122,96.5,89.5,191,65,2.9384615384615387
validation,crazing_244.xml,200,200,crazing,36,6,195,89,115.5,47.5,159,83,1.9156626506024097
validation,crazing_244.xml,200,200,crazing,8,127,198,192,103.0,159.5,190,65,2.923076923076923
validation,crazing_245.xml,200,200,crazing,63,1,178,81,120.5,41.0,115,80,1.4375
validation,crazing_245.xml,200,200,crazing,82,121,200,164,141.0,142.5,118,43,2.744186046511628
validation,crazing_246.xml,200,200,crazing,4,1,200,60,102.0,30.5,196,59,3.3220338983050848
validation,crazing_246.xml,200,200,crazing,41,109,199,173,120.0,141.0,158,64,2.46875
validation,crazing_246.xml,200,200,crazing,1,73,169,124,85.0,98.5,168,51,3.2941176470588234
validation,crazing_246.xml,200,200,crazing,23,19,179,90,101.0,54.5,156,71,2.1971830985915495
validation,crazing_247.xml,200,200,crazing,1,1,129,68,65.0,34.5,128,67,1.9104477611940298
validation,crazing_247.xml,200,200,crazing,1,134,88,190,44.5,162.0,87,56,1.5535714285714286
validation,crazing_247.xml,200,200,crazing,1,48,148,134,74.5,91.0,147,86,1.7093023255813953
validation,crazing_248.xml,200,200,crazing,2,52,179,152,90.5,102.0,177,100,1.77
validation,crazing_248.xml,200,200,crazing,77,23,200,83,138.5,53.0,123,60,2.05
validation,crazing_248.xml,200,200,crazing,18,127,197,192,107.5,159.5,179,65,2.753846153846154
validation,crazing_249.xml,200,200,crazing,9,10,131,52,70.0,31.0,122,42,2.9047619047619047
validation,crazing_249.xml,200,200,crazing,1,62,119,174,60.0,118.0,118,112,1.0535714285714286
validation,crazing_249.xml,200,200,crazing,66,111,200,191,133.0,151.0,134,80,1.675
validation,crazing_250.xml,200,200,crazing,7,2,168,46,87.5,24.0,161,44,3.659090909090909
validation,crazing_250.xml,200,200,crazing,38,18,191,111,114.5,64.5,153,93,1.6451612903225807
validation,crazing_250.xml,200,200,crazing,28,121,200,180,114.0,150.5,172,59,2.9152542372881354
validation,crazing_251.xml,200,200,crazing,4,80,95,192,49.5,136.0,91,112,0.8125
validation,crazing_251.xml,200,200,crazing,42,7,200,65,121.0,36.0,158,58,2.7241379310344827
validation,crazing_251.xml,200,200,crazing,138,48,192,173,165.0,110.5,54,125,0.432
validation,crazing_252.xml,200,200,crazing,1,6,104,59,52.5,32.5,103,53,1.9433962264150944
validation,crazing_252.xml,200,200,crazing,1,82,199,157,100.0,119.5,198,75,2.64
validation,crazing_252.xml,200,200,crazing,108,1,191,78,149.5,39.5,83,77,1.077922077922078
validation,crazing_253.xml,200,200,crazing,31,14,183,134,107.0,74.0,152,120,1.2666666666666666
validation,crazing_253.xml,200,200,crazing,131,2,193,70,162.0,36.0,62,68,0.9117647058823529
validation,crazing_253.xml,200,200,crazing,87,101,196,197,141.5,149.0,109,96,1.1354166666666667
validation,crazing_254.xml,200,200,crazing,46,26,183,162,114.5,94.0,137,136,1.0073529411764706
validation,crazing_255.xml,200,200,crazing,40,102,189,166,114.5,134.0,149,64,2.328125
validation,crazing_255.xml,200,200,crazing,4,2,200,57,102.0,29.5,196,55,3.5636363636363635
validation,crazing_255.xml,200,200,crazing,19,36,189,95,104.0,65.5,170,59,2.8813559322033897
validation,crazing_256.xml,200,200,crazing,24,125,196,187,110.0,156.0,172,62,2.774193548387097
validation,crazing_256.xml,200,200,crazing,31,48,175,119,103.0,83.5,144,71,2.028169014084507
validation,crazing_256.xml,200,200,crazing,57,1,164,50,110.5,25.5,107,49,2.183673469387755
validation,crazing_257.xml,200,200,crazing,1,27,101,90,51.0,58.5,100,63,1.5873015873015872
validation,crazing_257.xml,200,200,crazing,12,1,160,30,86.0,15.5,148,29,5.103448275862069
validation,crazing_257.xml,200,200,crazing,9,149,186,198,97.5,173.5,177,49,3.6122448979591835
validation,crazing_258.xml,200,200,crazing,50,36,178,124,114.0,80.0,128,88,1.4545454545454546
validation,crazing_258.xml,200,200,crazing,65,126,164,199,114.5,162.5,99,73,1.356164383561644
validation,crazing_259.xml,200,200,crazing,24,1,156,86,90.0,43.5,132,85,1.5529411764705883
validation,crazing_259.xml,200,200,crazing,9,81,160,135,84.5,108.0,151,54,2.7962962962962963
validation,crazing_259.xml,200,200,crazing,1,130,153,198,77.0,164.0,152,68,2.235294117647059
validation,crazing_260.xml,200,200,crazing,1,94,179,198,90.0,146.0,178,104,1.7115384615384615
validation,crazing_260.xml,200,200,crazing,3,19,198,99,100.5,59.0,195,80,2.4375
validation,crazing_261.xml,200,200,crazing,34,1,199,67,116.5,34.0,165,66,2.5
validation,crazing_261.xml,200,200,crazing,3,64,119,158,61.0,111.0,116,94,1.2340425531914894
validation,crazing_261.xml,200,200,crazing,25,145,180,200,102.5,172.5,155,55,2.8181818181818183
validation,crazing_262.xml,200,200,crazing,22,29,188,135,105.0,82.0,166,106,1.5660377358490567
validation,crazing_262.xml,200,200,crazing,57,138,186,197,121.5,167.5,129,59,2.1864406779661016
validation,crazing_262.xml,200,200,crazing,1,89,62,151,31.5,120.0,61,62,0.9838709677419355
validation,crazing_263.xml,200,200,crazing,1,16,170,108,85.5,62.0,169,92,1.8369565217391304
validation,crazing_263.xml,200,200,crazing,1,120,168,189,84.5,154.5,167,69,2.420289855072464
validation,crazing_264.xml,200,200,crazing,1,23,106,78,53.5,50.5,105,55,1.9090909090909092
validation,crazing_264.xml,200,200,crazing,2,77,200,165,101.0,121.0,198,88,2.25
validation,crazing_265.xml,200,200,crazing,1,13,198,110,99.5,61.5,197,97,2.0309278350515463
validation,crazing_265.xml,200,200,crazing,4,119,133,186,68.5,152.5,129,67,1.9253731343283582
validation,crazing_266.xml,200,200,crazing,3,6,193,101,98.0,53.5,190,95,2.0
validation,crazing_266.xml,200,200,crazing,1,130,138,199,69.5,164.5,137,69,1.9855072463768115
validation,crazing_267.xml,200,200,crazing,12,5,177,56,94.5,30.5,165,51,3.235294117647059
validation,crazing_267.xml,200,200,crazing,1,48,131,94,66.0,71.0,130,46,2.8260869565217392
validation,crazing_267.xml,200,200,crazing,3,95,88,182,45.5,138.5,85,87,0.9770114942528736
validation,crazing_268.xml,200,200,crazing,27,31,195,138,111.0,84.5,168,107,1.5700934579439252
validation,crazing_268.xml,200,200,crazing,86,10,197,76,141.5,43.0,111,66,1.6818181818181819
validation,crazing_268.xml,200,200,crazing,1,120,155,189,78.0,154.5,154,69,2.2318840579710146
validation,crazing_269.xml,200,200,crazing,67,14,175,93,121.0,53.5,108,79,1.3670886075949367
validation,crazing_269.xml,200,200,crazing,1,122,160,187,80.5,154.5,159,65,2.4461538461538463
validation,crazing_269.xml,200,200,crazing,97,54,172,120,134.5,87.0,75,66,1.1363636363636365
validation,crazing_270.xml,200,200,crazing,22,84,198,164,110.0,124.0,176,80,2.2
validation,crazing_270.xml,200,200,crazing,59,1,197,94,128.0,47.5,138,93,1.4838709677419355
validation,crazing_270.xml,200,200,crazing,1,123,78,191,39.5,157.0,77,68,1.1323529411764706
validation,crazing_271.xml,200,200,crazing,38,19,193,67,115.5,43.0,155,48,3.2291666666666665
validation,crazing_271.xml,200,200,crazing,2,70,70,186,36.0,128.0,68,116,0.5862068965517241
validation,crazing_271.xml,200,200,crazing,7,125,191,184,99.0,154.5,184,59,3.1186440677966103
validation,crazing_271.xml,200,200,crazing,96,42,190,134,143.0,88.0,94,92,1.0217391304347827
validation,crazing_272.xml,200,200,crazing,2,52,125,120,63.5,86.0,123,68,1.8088235294117647
validation,crazing_272.xml,200,200,crazing,45,1,200,67,122.5,34.0,155,66,2.3484848484848486
validation,crazing_272.xml,200,200,crazing,2,118,185,191,93.5,154.5,183,73,2.506849315068493
validation,crazing_273.xml,200,200,crazing,70,2,196,123,133.0,62.5,126,121,1.0413223140495869
validation,crazing_273.xml,200,200,crazing,4,1,151,37,77.5,19.0,147,36,4.083333333333333
validation,crazing_273.xml,200,200,crazing,5,75,116,134,60.5,104.5,111,59,1.88135593220339
validation,crazing_274.xml,200,200,crazing,1,60,158,131,79.5,95.5,157,71,2.211267605633803
validation,crazing_274.xml,200,200,crazing,12,1,194,56,103.0,28.5,182,55,3.309090909090909
validation,crazing_274.xml,200,200,crazing,32,138,147,185,89.5,161.5,115,47,2.4468085106382977
validation,crazing_274.xml,200,200,crazing,130,105,192,156,161.0,130.5,62,51,1.2156862745098038
validation,crazing_275.xml,200,200,crazing,10,26,99,141,54.5,83.5,89,115,0.7739130434782608
validation,crazing_275.xml,200,200,crazing,3,142,183,197,93.0,169.5,180,55,3.272727272727273
validation,crazing_275.xml,200,200,crazing,58,53,200,169,129.0,111.0,142,116,1.2241379310344827
validation,crazing_276.xml,200,200,crazing,8,27,172,110,90.0,68.5,164,83,1.9759036144578312
validation,crazing_276.xml,200,200,crazing,50,115,147,199,98.5,157.0,97,84,1.1547619047619047
validation,crazing_277.xml,200,200,crazing,49,3,200,71,124.5,37.0,151,68,2.2205882352941178
validation,crazing_277.xml,200,200,crazing,2,95,87,187,44.5,141.0,85,92,0.9239130434782609
validation,crazing_278.xml,200,200,crazing,1,27,131,72,66.0,49.5,130,45,2.888888888888889
validation,crazing_278.xml,200,200,crazing,36,68,193,150,114.5,109.0,157,82,1.9146341463414633
validation,crazing_278.xml,200,200,crazing,20,123,199,179,109.5,151.0,179,56,3.1964285714285716
validation,crazing_278.xml,200,200,crazing,1,1,91,34,46.0,17.5,90,33,2.727272727272727
validation,crazing_279.xml,200,200,crazing,41,24,176,121,108.5,72.5,135,97,1.3917525773195876
validation,crazing_279.xml,200,200,crazing,13,142,200,199,106.5,170.5,187,57,3.280701754385965
validation,crazing_280.xml,200,200,crazing,4,108,106,185,55.0,146.5,102,77,1.3246753246753247
validation,crazing_281.xml,200,200,crazing,59,121,188,185,123.5,153.0,129,64,2.015625
validation,crazing_281.xml,200,200,crazing,10,26,152,100,81.0,63.0,142,74,1.9189189189189189
validation,crazing_282.xml,200,200,crazing,37,31,181,100,109.0,65.5,144,69,2.0869565217391304
validation,crazing_282.xml,200,200,crazing,1,132,92,195,46.5,163.5,91,63,1.4444444444444444
validation,crazing_283.xml,200,200,crazing,48,2,177,46,112.5,24.0,129,44,2.9318181818181817
validation,crazing_283.xml,200,200,crazing,3,44,86,105,44.5,74.5,83,61,1.360655737704918
validation,crazing_283.xml,200,200,crazing,60,57,200,119,130.0,88.0,140,62,2.2580645161290325
validation,crazing_283.xml,200,200,crazing,3,106,75,192,39.0,149.0,72,86,0.8372093023255814
validation,crazing_284.xml,200,200,crazing,78,83,184,170,131.0,126.5,106,87,1.2183908045977012
validation,crazing_284.xml,200,200,crazing,17,16,129,102,73.0,59.0,112,86,1.302325581395349
validation,crazing_285.xml,200,200,crazing,108,18,198,120,153.0,69.0,90,102,0.8823529411764706
validation,crazing_285.xml,200,200,crazing,1,11,83,65,42.0,38.0,82,54,1.5185185185185186
validation,crazing_285.xml,200,200,crazing,86,118,197,196,141.5,157.0,111,78,1.4230769230769231
validation,crazing_286.xml,200,200,crazing,1,9,181,38,91.0,23.5,180,29,6.206896551724138
validation,crazing_286.xml,200,200,crazing,17,120,195,154,106.0,137.0,178,34,5.235294117647059
validation,crazing_286.xml,200,200,crazing,6,54,125,111,65.5,82.5,119,57,2.087719298245614
validation,crazing_287.xml,200,200,crazing,6,31,89,124,47.5,77.5,83,93,0.8924731182795699
validation,crazing_287.xml,200,200,crazing,1,116,131,191,66.0,153.5,130,75,1.7333333333333334
validation,crazing_288.xml,200,200,crazing,1,3,95,85,48.0,44.0,94,82,1.146341463414634
validation,crazing_288.xml,200,200,crazing,16,126,165,188,90.5,157.0,149,62,2.403225806451613
validation,crazing_289.xml,200,200,crazing,44,26,183,191,113.5,108.5,139,165,0.8424242424242424
validation,crazing_290.xml,200,200,crazing,1,104,159,172,80.0,138.0,158,68,2.323529411764706
validation,crazing_290.xml,200,200,crazing,12,25,145,92,78.5,58.5,133,67,1.9850746268656716
validation,crazing_290.xml,200,200,crazing,124,1,189,44,156.5,22.5,65,43,1.5116279069767442
validation,crazing_291.xml,200,200,crazing,7,1,194,57,100.5,29.0,187,56,3.3392857142857144
validation,crazing_291.xml,200,200,crazing,1,48,160,120,80.5,84.0,159,72,2.2083333333333335
validation,crazing_291.xml,200,200,crazing,1,81,181,151,91.0,116.0,180,70,2.5714285714285716
validation,crazing_292.xml,200,200,crazing,2,129,192,194,97.0,161.5,190,65,2.923076923076923
validation,crazing_292.xml,200,200,crazing,2,1,121,58,61.5,29.5,119,57,2.087719298245614
validation,crazing_292.xml,200,200,crazing,101,62,199,106,150.0,84.0,98,44,2.227272727272727
validation,crazing_293.xml,200,200,crazing,36,1,196,105,116.0,53.0,160,104,1.5384615384615385
validation,crazing_293.xml,200,200,crazing,8,49,134,129,71.0,89.0,126,80,1.575
validation,crazing_293.xml,200,200,crazing,29,121,172,188,100.5,154.5,143,67,2.1343283582089554
validation,crazing_294.xml,200,200,crazing,45,1,158,86,101.5,43.5,113,85,1.3294117647058823
validation,crazing_294.xml,200,200,crazing,1,82,166,200,83.5,141.0,165,118,1.3983050847457628
validation,crazing_295.xml,200,200,crazing,10,4,162,76,86.0,40.0,152,72,2.111111111111111
validation,crazing_295.xml,200,200,crazing,6,72,167,157,86.5,114.5,161,85,1.8941176470588235
validation,crazing_296.xml,200,200,crazing,2,31,176,111,89.0,71.0,174,80,2.175
validation,crazing_296.xml,200,200,crazing,36,99,173,165,104.5,132.0,137,66,2.0757575757575757
validation,crazing_297.xml,200,200,crazing,1,19,111,96,56.0,57.5,110,77,1.4285714285714286
validation,crazing_297.xml,200,200,crazing,116,1,192,77,154.0,39.0,76,76,1.0
validation,crazing_297.xml,200,200,crazing,8,110,193,169,100.5,139.5,185,59,3.135593220338983
validation,crazing_298.xml,200,200,crazing,3,35,174,101,88.5,68.0,171,66,2.590909090909091
validation,crazing_298.xml,200,200,crazing,4,112,195,199,99.5,155.5,191,87,2.1954022988505746
validation,crazing_299.xml,200,200,crazing,3,1,200,42,101.5,21.5,197,41,4.804878048780488
validation,crazing_299.xml,200,200,crazing,2,45,182,126,92.0,85.5,180,81,2.2222222222222223
validation,crazing_299.xml,200,200,crazing,126,23,194,75,160.0,49.0,68,52,1.3076923076923077
validation,crazing_299.xml,200,200,crazing,85,155,190,196,137.5,175.5,105,41,2.5609756097560976
validation,crazing_300.xml,200,200,crazing,2,1,169,66,85.5,33.5,167,65,2.5692307692307694
validation,crazing_300.xml,200,200,crazing,1,69,186,145,93.5,107.0,185,76,2.4342105263157894
validation,crazing_300.xml,200,200,crazing,98,90,192,197,145.0,143.5,94,107,0.8785046728971962
validation,inclusion_241.xml,200,200,inclusion,126,76,140,115,133.0,95.5,14,39,0.358974358974359
validation,inclusion_241.xml,200,200,inclusion,18,124,36,170,27.0,147.0,18,46,0.391304347826087
validation,inclusion_242.xml,200,200,inclusion,122,34,138,85,130.0,59.5,16,51,0.3137254901960784
validation,inclusion_242.xml,200,200,inclusion,97,91,137,158,117.0,124.5,40,67,0.5970149253731343
validation,inclusion_243.xml,200,200,inclusion,56,41,74,88,65.0,64.5,18,47,0.3829787234042553
validation,inclusion_243.xml,200,200,inclusion,10,72,40,149,25.0,110.5,30,77,0.38961038961038963
validation,inclusion_243.xml,200,200,inclusion,134,52,153,114,143.5,83.0,19,62,0.3064516129032258
validation,inclusion_244.xml,200,200,inclusion,49,6,86,71,67.5,38.5,37,65,0.5692307692307692
validation,inclusion_244.xml,200,200,inclusion,175,5,195,52,185.0,28.5,20,47,0.425531914893617
validation,inclusion_244.xml,200,200,inclusion,44,146,101,199,72.5,172.5,57,53,1.0754716981132075
validation,inclusion_245.xml,200,200,inclusion,85,81,137,180,111.0,130.5,52,99,0.5252525252525253
validation,inclusion_246.xml,200,200,inclusion,55,122,79,190,67.0,156.0,24,68,0.35294117647058826
validation,inclusion_246.xml,200,200,inclusion,161,1,193,198,177.0,99.5,32,197,0.16243654822335024
validation,inclusion_247.xml,200,200,inclusion,90,1,125,197,107.5,99.0,35,196,0.17857142857142858
validation,inclusion_248.xml,200,200,inclusion,129,1,157,196,143.0,98.5,28,195,0.14358974358974358
validation,inclusion_249.xml,200,200,inclusion,50,1,75,79,62.5,40.0,25,78,0.32051282051282054
validation,inclusion_249.xml,200,200,inclusion,43,69,72,200,57.5,134.5,29,131,0.22137404580152673
validation,inclusion_250.xml,200,200,inclusion,90,1,125,198,107.5,99.5,35,197,0.17766497461928935
validation,inclusion_251.xml,200,200,inclusion,115,50,133,113,124.0,81.5,18,63,0.2857142857142857
validation,inclusion_252.xml,200,200,inclusion,54,2,78,187,66.0,94.5,24,185,0.12972972972972974
validation,inclusion_252.xml,200,200,inclusion,143,2,166,68,154.5,35.0,23,66,0.3484848484848485
validation,inclusion_253.xml,200,200,inclusion,133,1,155,124,144.0,62.5,22,123,0.17886178861788618
validation,inclusion_254.xml,200,200,inclusion,63,1,88,165,75.5,83.0,25,164,0.1524390243902439
validation,inclusion_254.xml,200,200,inclusion,68,142,101,198,84.5,170.0,33,56,0.5892857142857143
validation,inclusion_255.xml,200,200,inclusion,89,1,121,87,105.0,44.0,32,86,0.37209302325581395
validation,inclusion_255.xml,200,200,inclusion,84,101,119,199,101.5,150.0,35,98,0.35714285714285715
validation,inclusion_256.xml,200,200,inclusion,117,1,157,149,137.0,75.0,40,148,0.2702702702702703
validation,inclusion_256.xml,200,200,inclusion,121,98,144,198,132.5,148.0,23,100,0.23
validation,inclusion_257.xml,200,200,inclusion,69,1,95,113,82.0,57.0,26,112,0.23214285714285715
validation,inclusion_257.xml,200,200,inclusion,64,108,88,190,76.0,149.0,24,82,0.2926829268292683
validation,inclusion_258.xml,200,200,inclusion,25,6,67,192,46.0,99.0,42,186,0.22580645161290322
validation,inclusion_258.xml,200,200,inclusion,130,1,175,199,152.5,100.0,45,198,0.22727272727272727
validation,inclusion_259.xml,200,200,inclusion,132,29,163,195,147.5,112.0,31,166,0.18674698795180722
validation,inclusion_260.xml,200,200,inclusion,149,58,170,133,159.5,95.5,21,75,0.28
validation,inclusion_260.xml,200,200,inclusion,39,24,68,198,53.5,111.0,29,174,0.16666666666666666
validation,inclusion_261.xml,200,200,inclusion,146,45,167,114,156.5,79.5,21,69,0.30434782608695654
validation,inclusion_261.xml,200,200,inclusion,30,4,62,188,46.0,96.0,32,184,0.17391304347826086
validation,inclusion_262.xml,200,200,inclusion,1,3,44,197,22.5,100.0,43,194,0.22164948453608246
validation,inclusion_262.xml,200,200,inclusion,118,12,151,199,134.5,105.5,33,187,0.17647058823529413
validation,inclusion_262.xml,200,200,inclusion,26,107,56,162,41.0,134.5,30,55,0.5454545454545454
validation,inclusion_263.xml,200,200,inclusion,81,1,106,158,93.5,79.5,25,157,0.1592356687898089
validation,inclusion_263.xml,200,200,inclusion,80,145,98,198,89.0,171.5,18,53,0.33962264150943394
validation,inclusion_264.xml,200,200,inclusion,26,1,64,190,45.0,95.5,38,189,0.20105820105820105
validation,inclusion_264.xml,200,200,inclusion,134,1,176,196,155.0,98.5,42,195,0.2153846153846154
validation,inclusion_264.xml,200,200,inclusion,47,13,68,92,57.5,52.5,21,79,0.26582278481012656
validation,inclusion_264.xml,200,200,inclusion,32,149,56,199,44.0,174.0,24,50,0.48
validation,inclusion_265.xml,200,200,inclusion,24,1,45,67,34.5,34.0,21,66,0.3181818181818182
validation,inclusion_265.xml,200,200,inclusion,23,75,44,117,33.5,96.0,21,42,0.5
validation,inclusion_265.xml,200,200,inclusion,136,1,176,198,156.0,99.5,40,197,0.20304568527918782
validation,inclusion_266.xml,200,200,inclusion,29,26,68,149,48.5,87.5,39,123,0.3170731707317073
validation,inclusion_266.xml,200,200,inclusion,138,1,179,199,158.5,100.0,41,198,0.20707070707070707
validation,inclusion_266.xml,200,200,inclusion,20,123,46,174,33.0,148.5,26,51,0.5098039215686274
validation,inclusion_267.xml,200,200,inclusion,33,106,56,183,44.5,144.5,23,77,0.2987012987012987
validation,inclusion_267.xml,200,200,inclusion,141,36,183,199,162.0,117.5,42,163,0.25766871165644173
validation,inclusion_267.xml,200,200,inclusion,153,5,171,42,162.0,23.5,18,37,0.4864864864864865
validation,inclusion_268.xml,200,200,inclusion,133,1,171,199,152.0,100.0,38,198,0.1919191919191919
validation,inclusion_269.xml,200,200,inclusion,46,94,73,199,59.5,146.5,27,105,0.2571428571428571
validation,inclusion_269.xml,200,200,inclusion,54,13,72,61,63.0,37.0,18,48,0.375
validation,inclusion_269.xml,200,200,inclusion,142,1,179,196,160.5,98.5,37,195,0.18974358974358974
validation,inclusion_270.xml,200,200,inclusion,26,1,64,199,45.0,100.0,38,198,0.1919191919191919
validation,inclusion_271.xml,200,200,inclusion,23,3,56,199,39.5,101.0,33,196,0.1683673469387755
validation,inclusion_271.xml,200,200,inclusion,68,46,90,131,79.0,88.5,22,85,0.25882352941176473
validation,inclusion_271.xml,200,200,inclusion,176,100,199,199,187.5,149.5,23,99,0.23232323232323232
validation,inclusion_272.xml,200,200,inclusion,30,40,58,188,44.0,114.0,28,148,0.1891891891891892
validation,inclusion_272.xml,200,200,inclusion,135,118,155,191,145.0,154.5,20,73,0.273972602739726
validation,inclusion_272.xml,200,200,inclusion,138,1,157,52,147.5,26.5,19,51,0.37254901960784315
validation,inclusion_273.xml,200,200,inclusion,27,93,46,151,36.5,122.0,19,58,0.3275862068965517
validation,inclusion_273.xml,200,200,inclusion,26,27,48,96,37.0,61.5,22,69,0.3188405797101449
validation,inclusion_274.xml,200,200,inclusion,112,28,142,181,127.0,104.5,30,153,0.19607843137254902
validation,inclusion_274.xml,200,200,inclusion,13,39,44,192,28.5,115.5,31,153,0.20261437908496732
validation,inclusion_274.xml,200,200,inclusion,19,4,41,43,30.0,23.5,22,39,0.5641025641025641
validation,inclusion_274.xml,200,200,inclusion,168,1,180,37,174.0,19.0,12,36,0.3333333333333333
validation,inclusion_275.xml,200,200,inclusion,30,124,46,162,38.0,143.0,16,38,0.42105263157894735
validation,inclusion_275.xml,200,200,inclusion,63,23,86,120,74.5,71.5,23,97,0.23711340206185566
validation,inclusion_275.xml,200,200,inclusion,155,149,171,195,163.0,172.0,16,46,0.34782608695652173
validation,inclusion_275.xml,200,200,inclusion,152,63,177,129,164.5,96.0,25,66,0.3787878787878788
validation,inclusion_275.xml,200,200,inclusion,152,18,173,51,162.5,34.5,21,33,0.6363636363636364
validation,inclusion_275.xml,200,200,inclusion,66,126,86,171,76.0,148.5,20,45,0.4444444444444444
validation,inclusion_276.xml,200,200,inclusion,85,3,134,197,109.5,100.0,49,194,0.25257731958762886
validation,inclusion_276.xml,200,200,inclusion,84,1,109,85,96.5,43.0,25,84,0.2976190476190476
validation,inclusion_277.xml,200,200,inclusion,31,1,65,199,48.0,100.0,34,198,0.1717171717171717
validation,inclusion_278.xml,200,200,inclusion,33,115,51,152,42.0,133.5,18,37,0.4864864864864865
validation,inclusion_278.xml,200,200,inclusion,136,1,171,199,153.5,100.0,35,198,0.17676767676767677
validation,inclusion_278.xml,200,200,inclusion,38,52,59,86,48.5,69.0,21,34,0.6176470588235294
validation,inclusion_279.xml,200,200,inclusion,72,12,94,62,83.0,37.0,22,50,0.44
validation,inclusion_279.xml,200,200,inclusion,67,59,97,184,82.0,121.5,30,125,0.24
validation,inclusion_280.xml,200,200,inclusion,42,29,68,197,55.0,113.0,26,168,0.15476190476190477
validation,inclusion_280.xml,200,200,inclusion,48,1,66,71,57.0,36.0,18,70,0.2571428571428571
validation,inclusion_281.xml,200,200,inclusion,136,31,153,80,144.5,55.5,17,49,0.3469387755102041
validation,inclusion_281.xml,200,200,inclusion,130,97,155,174,142.5,135.5,25,77,0.3246753246753247
validation,inclusion_282.xml,200,200,inclusion,91,20,121,114,106.0,67.0,30,94,0.3191489361702128
validation,inclusion_282.xml,200,200,inclusion,91,96,110,181,100.5,138.5,19,85,0.2235294117647059
validation,inclusion_283.xml,200,200,inclusion,33,9,62,190,47.5,99.5,29,181,0.16022099447513813
validation,inclusion_284.xml,200,200,inclusion,25,106,43,135,34.0,120.5,18,29,0.6206896551724138
validation,inclusion_284.xml,200,200,inclusion,166,33,198,107,182.0,70.0,32,74,0.43243243243243246
validation,inclusion_285.xml,200,200,inclusion,61,5,100,196,80.5,100.5,39,191,0.20418848167539266
validation,inclusion_286.xml,200,200,inclusion,46,4,68,70,57.0,37.0,22,66,0.3333333333333333
validation,inclusion_286.xml,200,200,inclusion,40,66,68,200,54.0,133.0,28,134,0.208955223880597
validation,inclusion_287.xml,200,200,inclusion,3,20,20,52,11.5,36.0,17,32,0.53125
validation,inclusion_287.xml,200,200,inclusion,27,137,46,190,36.5,163.5,19,53,0.3584905660377358
validation,inclusion_287.xml,200,200,inclusion,91,3,113,137,102.0,70.0,22,134,0.16417910447761194
validation,inclusion_287.xml,200,200,inclusion,145,7,174,182,159.5,94.5,29,175,0.1657142857142857
validation,inclusion_287.xml,200,200,inclusion,21,47,45,138,33.0,92.5,24,91,0.26373626373626374
validation,inclusion_287.xml,200,200,inclusion,3,105,21,146,12.0,125.5,18,41,0.43902439024390244
validation,inclusion_287.xml,200,200,inclusion,28,19,42,49,35.0,34.0,14,30,0.4666666666666667
validation,inclusion_287.xml,200,200,inclusion,2,50,19,107,10.5,78.5,17,57,0.2982456140350877
validation,inclusion_288.xml,200,200,inclusion,28,6,58,185,43.0,95.5,30,179,0.16759776536312848
validation,inclusion_288.xml,200,200,inclusion,26,138,46,199,36.0,168.5,20,61,0.32786885245901637
validation,inclusion_289.xml,200,200,inclusion,42,1,62,40,52.0,20.5,20,39,0.5128205128205128
validation,inclusion_289.xml,200,200,inclusion,40,34,67,99,53.5,66.5,27,65,0.4153846153846154
validation,inclusion_289.xml,200,200,inclusion,43,150,67,200,55.0,175.0,24,50,0.48
validation,inclusion_289.xml,200,200,inclusion,40,101,64,150,52.0,125.5,24,49,0.4897959183673469
validation,inclusion_290.xml,200,200,inclusion,23,1,57,179,40.0,90.0,34,178,0.19101123595505617
validation,inclusion_291.xml,200,200,inclusion,84,29,108,163,96.0,96.0,24,134,0.1791044776119403
validation,inclusion_291.xml,200,200,inclusion,168,2,199,164,183.5,83.0,31,162,0.19135802469135801
validation,inclusion_291.xml,200,200,inclusion,83,4,96,46,89.5,25.0,13,42,0.30952380952380953
validation,inclusion_291.xml,200,200,inclusion,1,6,31,166,16.0,86.0,30,160,0.1875
validation,inclusion_292.xml,200,200,inclusion,3,46,18,74,10.5,60.0,15,28,0.5357142857142857
validation,inclusion_292.xml,200,200,inclusion,77,27,99,82,88.0,54.5,22,55,0.4
validation,inclusion_292.xml,200,200,inclusion,83,89,108,166,95.5,127.5,25,77,0.3246753246753247
validation,inclusion_292.xml,200,200,inclusion,1,106,15,144,8.0,125.0,14,38,0.3684210526315789
validation,inclusion_292.xml,200,200,inclusion,79,81,89,116,84.0,98.5,10,35,0.2857142857142857
validation,inclusion_292.xml,200,200,inclusion,93,164,108,200,100.5,182.0,15,36,0.4166666666666667
validation,inclusion_292.xml,200,200,inclusion,184,80,198,113,191.0,96.5,14,33,0.42424242424242425
validation,inclusion_293.xml,200,200,inclusion,110,67,129,135,119.5,101.0,19,68,0.27941176470588236
validation,inclusion_293.xml,200,200,inclusion,121,97,161,199,141.0,148.0,40,102,0.39215686274509803
validation,inclusion_293.xml,200,200,inclusion,35,1,64,94,49.5,47.5,29,93,0.3118279569892473
validation,inclusion_294.xml,200,200,inclusion,20,23,38,103,29.0,63.0,18,80,0.225
validation,inclusion_294.xml,200,200,inclusion,20,107,45,179,32.5,143.0,25,72,0.3472222222222222
validation,inclusion_295.xml,200,200,inclusion,130,14,162,188,146.0,101.0,32,174,0.1839080459770115
validation,inclusion_295.xml,200,200,inclusion,148,125,170,200,159.0,162.5,22,75,0.29333333333333333
validation,inclusion_296.xml,200,200,inclusion,51,1,80,176,65.5,88.5,29,175,0.1657142857142857
validation,inclusion_296.xml,200,200,inclusion,51,154,74,197,62.5,175.5,23,43,0.5348837209302325
validation,inclusion_297.xml,200,200,inclusion,21,2,60,184,40.5,93.0,39,182,0.21428571428571427
validation,inclusion_298.xml,200,200,inclusion,131,56,154,94,142.5,75.0,23,38,0.6052631578947368
validation,inclusion_298.xml,200,200,inclusion,157,157,173,192,165.0,174.5,16,35,0.45714285714285713
validation,inclusion_298.xml,200,200,inclusion,156,24,173,61,164.5,42.5,17,37,0.4594594594594595
validation,inclusion_298.xml,200,200,inclusion,158,61,180,110,169.0,85.5,22,49,0.4489795918367347
validation,inclusion_298.xml,200,200,inclusion,158,109,172,151,165.0,130.0,14,42,0.3333333333333333
validation,inclusion_299.xml,200,200,inclusion,117,68,137,127,127.0,97.5,20,59,0.3389830508474576
validation,inclusion_299.xml,200,200,inclusion,111,135,133,188,122.0,161.5,22,53,0.41509433962264153
validation,inclusion_300.xml,200,200,inclusion,142,50,166,119,154.0,84.5,24,69,0.34782608695652173
validation,inclusion_300.xml,200,200,inclusion,150,122,167,164,158.5,143.0,17,42,0.40476190476190477
validation,inclusion_300.xml,200,200,inclusion,132,137,145,168,138.5,152.5,13,31,0.41935483870967744
validation,patches_241.xml,200,200,patches,71,41,125,177,98.0,109.0,54,136,0.39705882352941174
validation,patches_242.xml,200,200,patches,7,37,85,157,46.0,97.0,78,120,0.65
validation,patches_242.xml,200,200,patches,103,92,165,135,134.0,113.5,62,43,1.441860465116279
validation,patches_242.xml,200,200,patches,147,1,194,55,170.5,28.0,47,54,0.8703703703703703
validation,patches_243.xml,200,200,patches,21,1,96,76,58.5,38.5,75,75,1.0
validation,patches_243.xml,200,200,patches,111,10,182,53,146.5,31.5,71,43,1.6511627906976745
validation,patches_243.xml,200,200,patches,10,149,84,200,47.0,174.5,74,51,1.4509803921568627
validation,patches_243.xml,200,200,patches,139,101,187,158,163.0,129.5,48,57,0.8421052631578947
validation,patches_243.xml,200,200,patches,27,88,72,162,49.5,125.0,45,74,0.6081081081081081
validation,patches_244.xml,200,200,patches,24,50,75,90,49.5,70.0,51,40,1.275
validation,patches_244.xml,200,200,patches,43,106,128,167,85.5,136.5,85,61,1.3934426229508197
validation,patches_245.xml,200,200,patches,5,37,44,71,24.5,54.0,39,34,1.1470588235294117
validation,patches_245.xml,200,200,patches,3,1,60,17,31.5,9.0,57,16,3.5625
validation,patches_245.xml,200,200,patches,1,98,84,195,42.5,146.5,83,97,0.8556701030927835
validation,patches_245.xml,200,200,patches,115,2,178,97,146.5,49.5,63,95,0.6631578947368421
validation,patches_245.xml,200,200,patches,131,122,182,163,156.5,142.5,51,41,1.2439024390243902
validation,patches_245.xml,200,200,patches,144,166,188,199,166.0,182.5,44,33,1.3333333333333333
validation,patches_245.xml,200,200,inclusion,176,3,199,41,187.5,22.0,23,38,0.6052631578947368
validation,patches_246.xml,200,200,patches,145,39,193,82,169.0,60.5,48,43,1.1162790697674418
validation,patches_246.xml,200,200,patches,4,1,60,172,32.0,86.5,56,171,0.32748538011695905
validation,patches_246.xml,200,200,patches,158,95,199,142,178.5,118.5,41,47,0.8723404255319149
validation,patches_246.xml,200,200,patches,100,128,163,170,131.5,149.0,63,42,1.5
validation,patches_246.xml,200,200,patches,30,33,95,98,62.5,65.5,65,65,1.0
validation,patches_247.xml,200,200,patches,8,56,44,199,26.0,127.5,36,143,0.2517482517482518
validation,patches_247.xml,200,200,patches,95,1,171,193,133.0,97.0,76,192,0.3958333333333333
validation,patches_248.xml,200,200,patches,10,1,73,68,41.5,34.5,63,67,0.9402985074626866
validation,patches_248.xml,200,200,patches,17,104,75,200,46.0,152.0,58,96,0.6041666666666666
validation,patches_248.xml,200,200,patches,159,1,198,36,178.5,18.5,39,35,1.1142857142857143
validation,patches_248.xml,200,200,patches,121,26,179,73,150.0,49.5,58,47,1.2340425531914894
validation,patches_248.xml,200,200,patches,141,79,179,121,160.0,100.0,38,42,0.9047619047619048
validation,patches_249.xml,200,200,patches,66,7,158,180,112.0,93.5,92,173,0.5317919075144508
validation,patches_249.xml,200,200,patches,116,25,156,102,136.0,63.5,40,77,0.5194805194805194
validation,patches_249.xml,200,200,inclusion,22,74,50,144,36.0,109.0,28,70,0.4
validation,patches_250.xml,200,200,patches,37,1,80,60,58.5,30.5,43,59,0.7288135593220338
validation,patches_250.xml,200,200,patches,19,103,71,200,45.0,151.5,52,97,0.5360824742268041
validation,patches_250.xml,200,200,patches,107,1,152,52,129.5,26.5,45,51,0.8823529411764706
validation,patches_250.xml,200,200,patches,119,130,156,195,137.5,162.5,37,65,0.5692307692307692
validation,patches_251.xml,200,200,patches,72,1,126,91,99.0,46.0,54,90,0.6
validation,patches_252.xml,200,200,patches,127,106,193,156,160.0,131.0,66,50,1.32
validation,patches_252.xml,200,200,patches,121,163,176,200,148.5,181.5,55,37,1.4864864864864864
validation,patches_252.xml,200,200,patches,19,150,62,197,40.5,173.5,43,47,0.9148936170212766
validation,patches_253.xml,200,200,patches,65,64,130,155,97.5,109.5,65,91,0.7142857142857143
validation,patches_253.xml,200,200,patches,2,29,34,89,18.0,59.0,32,60,0.5333333333333333
validation,patches_253.xml,200,200,patches,128,62,167,118,147.5,90.0,39,56,0.6964285714285714
validation,patches_254.xml,200,200,patches,60,128,109,191,84.5,159.5,49,63,0.7777777777777778
validation,patches_254.xml,200,200,patches,45,27,129,86,87.0,56.5,84,59,1.423728813559322
validation,patches_255.xml,200,200,patches,111,126,184,200,147.5,163.0,73,74,0.9864864864864865
validation,patches_255.xml,200,200,patches,142,10,178,39,160.0,24.5,36,29,1.2413793103448276
validation,patches_255.xml,200,200,patches,1,68,26,109,13.5,88.5,25,41,0.6097560975609756
validation,patches_256.xml,200,200,patches,6,1,88,79,47.0,40.0,82,78,1.0512820512820513
validation,patches_256.xml,200,200,patches,119,54,171,125,145.0,89.5,52,71,0.7323943661971831
validation,patches_257.xml,200,200,patches,10,131,60,175,35.0,153.0,50,44,1.1363636363636365
validation,patches_257.xml,200,200,patches,2,85,65,126,33.5,105.5,63,41,1.5365853658536586
validation,patches_257.xml,200,200,patches,1,13,42,89,21.5,51.0,41,76,0.5394736842105263
validation,patches_257.xml,200,200,patches,134,23,199,134,166.5,78.5,65,111,0.5855855855855856
validation,patches_258.xml,200,200,patches,91,60,154,148,122.5,104.0,63,88,0.7159090909090909
validation,patches_258.xml,200,200,patches,132,144,167,185,149.5,164.5,35,41,0.8536585365853658
validation,patches_258.xml,200,200,patches,22,81,52,116,37.0,98.5,30,35,0.8571428571428571
validation,patches_259.xml,200,200,patches,1,124,62,187,31.5,155.5,61,63,0.9682539682539683
validation,patches_259.xml,200,200,patches,78,8,119,36,98.5,22.0,41,28,1.4642857142857142
validation,patches_259.xml,200,200,patches,7,49,52,152,29.5,100.5,45,103,0.4368932038834951
validation,patches_259.xml,200,200,inclusion,34,47,68,81,51.0,64.0,34,34,1.0
validation,patches_259.xml,200,200,inclusion,171,8,199,26,185.0,17.0,28,18,1.5555555555555556
validation,patches_260.xml,200,200,patches,96,127,180,197,138.0,162.0,84,70,1.2
validation,patches_260.xml,200,200,inclusion,166,78,196,145,181.0,111.5,30,67,0.44776119402985076
validation,patches_261.xml,200,200,patches,15,75,60,141,37.5,108.0,45,66,0.6818181818181818
validation,patches_261.xml,200,200,patches,132,114,191,184,161.5,149.0,59,70,0.8428571428571429
validation,patches_261.xml,200,200,patches,100,122,135,163,117.5,142.5,35,41,0.8536585365853658
validation,patches_261.xml,200,200,patches,162,56,200,105,181.0,80.5,38,49,0.7755102040816326
validation,patches_262.xml,200,200,patches,81,82,149,200,115.0,141.0,68,118,0.576271186440678
validation,patches_262.xml,200,200,patches,1,112,40,187,20.5,149.5,39,75,0.52
validation,patches_262.xml,200,200,patches,14,53,53,101,33.5,77.0,39,48,0.8125
validation,patches_263.xml,200,200,patches,42,59,100,185,71.0,122.0,58,126,0.4603174603174603
validation,patches_263.xml,200,200,patches,58,124,162,200,110.0,162.0,104,76,1.368421052631579
validation,patches_264.xml,200,200,patches,34,52,104,185,69.0,118.5,70,133,0.5263157894736842
validation,patches_264.xml,200,200,patches,119,102,175,199,147.0,150.5,56,97,0.5773195876288659
validation,patches_265.xml,200,200,patches,1,115,62,197,31.5,156.0,61,82,0.7439024390243902
validation,patches_265.xml,200,200,patches,127,6,188,95,157.5,50.5,61,89,0.6853932584269663
validation,patches_265.xml,200,200,patches,18,43,52,82,35.0,62.5,34,39,0.8717948717948718
validation,patches_265.xml,200,200,inclusion,135,167,174,198,154.5,182.5,39,31,1.2580645161290323
validation,patches_266.xml,200,200,patches,74,5,182,103,128.0,54.0,108,98,1.1020408163265305
validation,patches_266.xml,200,200,patches,4,2,38,31,21.0,16.5,34,29,1.1724137931034482
validation,patches_266.xml,200,200,patches,9,6,62,76,35.5,41.0,53,70,0.7571428571428571
validation,patches_267.xml,200,200,patches,11,1,94,121,52.5,61.0,83,120,0.6916666666666667
validation,patches_267.xml,200,200,patches,21,149,78,189,49.5,169.0,57,40,1.425
validation,patches_267.xml,200,200,patches,138,62,194,197,166.0,129.5,56,135,0.4148148148148148
validation,patches_267.xml,200,200,patches,141,1,194,64,167.5,32.5,53,63,0.8412698412698413
validation,patches_268.xml,200,200,patches,14,9,78,199,46.0,104.0,64,190,0.3368421052631579
validation,patches_268.xml,200,200,patches,122,124,180,167,151.0,145.5,58,43,1.3488372093023255
validation,patches_268.xml,200,200,patches,144,16,181,58,162.5,37.0,37,42,0.8809523809523809
validation,patches_269.xml,200,200,patches,2,52,53,151,27.5,101.5,51,99,0.5151515151515151
validation,patches_269.xml,200,200,patches,115,40,159,174,137.0,107.0,44,134,0.3283582089552239
validation,patches_269.xml,200,200,patches,115,169,158,200,136.5,184.5,43,31,1.3870967741935485
validation,patches_270.xml,200,200,patches,88,72,146,171,117.0,121.5,58,99,0.5858585858585859
validation,patches_270.xml,200,200,patches,88,1,145,34,116.5,17.5,57,33,1.7272727272727273
validation,patches_271.xml,200,200,patches,87,53,175,125,131.0,89.0,88,72,1.2222222222222223
validation,patches_271.xml,200,200,patches,129,157,166,200,147.5,178.5,37,43,0.8604651162790697
validation,patches_272.xml,200,200,patches,51,29,109,141,80.0,85.0,58,112,0.5178571428571429
validation,patches_273.xml,200,200,patches,10,117,67,175,38.5,146.0,57,58,0.9827586206896551
validation,patches_273.xml,200,200,patches,13,50,53,95,33.0,72.5,40,45,0.8888888888888888
validation,patches_273.xml,200,200,patches,123,1,187,185,155.0,93.0,64,184,0.34782608695652173
validation,patches_274.xml,200,200,patches,97,139,164,199,130.5,169.0,67,60,1.1166666666666667
validation,patches_275.xml,200,200,patches,31,24,81,143,56.0,83.5,50,119,0.42016806722689076
validation,patches_275.xml,200,200,patches,64,126,108,169,86.0,147.5,44,43,1.0232558139534884
validation,patches_276.xml,200,200,patches,4,101,50,150,27.0,125.5,46,49,0.9387755102040817
validation,patches_276.xml,200,200,patches,34,1,84,71,59.0,36.0,50,70,0.7142857142857143
validation,patches_276.xml,200,200,patches,138,1,194,105,166.0,53.0,56,104,0.5384615384615384
validation,patches_276.xml,200,200,patches,141,68,176,131,158.5,99.5,35,63,0.5555555555555556
validation,patches_277.xml,200,200,patches,13,88,83,194,48.0,141.0,70,106,0.660377358490566
validation,patches_277.xml,200,200,patches,139,110,187,166,163.0,138.0,48,56,0.8571428571428571
validation,patches_277.xml,200,200,patches,131,1,181,53,156.0,27.0,50,52,0.9615384615384616
validation,patches_277.xml,200,200,patches,8,1,27,23,17.5,12.0,19,22,0.8636363636363636
validation,patches_278.xml,200,200,patches,41,1,115,120,78.0,60.5,74,119,0.6218487394957983
validation,patches_278.xml,200,200,patches,39,93,112,199,75.5,146.0,73,106,0.6886792452830188
validation,patches_279.xml,200,200,patches,11,33,72,81,41.5,57.0,61,48,1.2708333333333333
validation,patches_279.xml,200,200,patches,121,32,171,116,146.0,74.0,50,84,0.5952380952380952
validation,patches_279.xml,200,200,patches,154,153,189,199,171.5,176.0,35,46,0.7608695652173914
validation,patches_280.xml,200,200,patches,60,56,125,200,92.5,128.0,65,144,0.4513888888888889
validation,patches_280.xml,200,200,patches,77,4,114,93,95.5,48.5,37,89,0.4157303370786517
validation,patches_281.xml,200,200,patches,21,1,62,43,41.5,22.0,41,42,0.9761904761904762
validation,patches_281.xml,200,200,patches,119,1,172,198,145.5,99.5,53,197,0.26903553299492383
validation,patches_281.xml,200,200,patches,19,107,52,153,35.5,130.0,33,46,0.717391304347826
validation,patches_282.xml,200,200,patches,10,65,72,149,41.0,107.0,62,84,0.7380952380952381
validation,patches_282.xml,200,200,patches,131,70,186,200,158.5,135.0,55,130,0.4230769230769231
validation,patches_282.xml,200,200,patches,128,1,170,73,149.0,37.0,42,72,0.5833333333333334
validation,patches_283.xml,200,200,patches,51,4,104,73,77.5,38.5,53,69,0.7681159420289855
validation,patches_283.xml,200,200,patches,28,127,110,191,69.0,159.0,82,64,1.28125
validation,patches_283.xml,200,200,patches,76,109,126,162,101.0,135.5,50,53,0.9433962264150944
validation,patches_283.xml,200,200,patches,151,136,177,162,164.0,149.0,26,26,1.0
validation,patches_284.xml,200,200,patches,86,1,164,192,125.0,96.5,78,191,0.4083769633507853
validation,patches_284.xml,200,200,patches,46,120,105,179,75.5,149.5,59,59,1.0
validation,patches_285.xml,200,200,patches,64,1,127,135,95.5,68.0,63,134,0.4701492537313433
validation,patches_285.xml,200,200,patches,148,1,200,46,174.0,23.5,52,45,1.1555555555555554
validation,patches_285.xml,200,200,patches,73,126,135,200,104.0,163.0,62,74,0.8378378378378378
validation,patches_286.xml,200,200,patches,65,29,143,199,104.0,114.0,78,170,0.4588235294117647
validation,patches_286.xml,200,200,patches,168,91,200,157,184.0,124.0,32,66,0.48484848484848486
validation,patches_286.xml,200,200,patches,68,1,139,34,103.5,17.5,71,33,2.1515151515151514
validation,patches_286.xml,200,200,patches,1,54,15,89,8.0,71.5,14,35,0.4
validation,patches_287.xml,200,200,patches,77,1,146,199,111.5,100.0,69,198,0.3484848484848485
validation,patches_287.xml,200,200,patches,172,1,200,18,186.0,9.5,28,17,1.6470588235294117
validation,patches_288.xml,200,200,patches,114,17,194,190,154.0,103.5,80,173,0.4624277456647399
validation,patches_288.xml,200,200,patches,26,155,56,183,41.0,169.0,30,28,1.0714285714285714
validation,patches_289.xml,200,200,patches,1,10,39,90,20.0,50.0,38,80,0.475
validation,patches_289.xml,200,200,patches,2,96,37,199,19.5,147.5,35,103,0.33980582524271846
validation,patches_289.xml,200,200,patches,114,101,193,181,153.5,141.0,79,80,0.9875
validation,patches_289.xml,200,200,patches,150,18,179,46,164.5,32.0,29,28,1.0357142857142858
validation,patches_289.xml,200,200,patches,52,68,85,110,68.5,89.0,33,42,0.7857142857142857
validation,patches_290.xml,200,200,patches,10,25,60,107,35.0,66.0,50,82,0.6097560975609756
validation,patches_290.xml,200,200,patches,7,119,63,199,35.0,159.0,56,80,0.7
validation,patches_290.xml,200,200,patches,127,105,186,200,156.5,152.5,59,95,0.6210526315789474
validation,patches_290.xml,200,200,patches,125,1,190,50,157.5,25.5,65,49,1.3265306122448979
validation,patches_290.xml,200,200,patches,132,45,190,115,161.0,80.0,58,70,0.8285714285714286
validation,patches_291.xml,200,200,patches,21,40,68,119,44.5,79.5,47,79,0.5949367088607594
validation,patches_291.xml,200,200,patches,9,122,84,198,46.5,160.0,75,76,0.9868421052631579
validation,patches_291.xml,200,200,patches,125,1,187,195,156.0,98.0,62,194,0.31958762886597936
validation,patches_291.xml,200,200,patches,9,1,49,28,29.0,14.5,40,27,1.4814814814814814
validation,patches_292.xml,200,200,patches,59,49,106,118,82.5,83.5,47,69,0.6811594202898551
validation,patches_292.xml,200,200,patches,52,1,100,22,76.0,11.5,48,21,2.2857142857142856
validation,patches_292.xml,200,200,patches,142,51,194,170,168.0,110.5,52,119,0.4369747899159664
validation,patches_292.xml,200,200,patches,1,8,24,47,12.5,27.5,23,39,0.5897435897435898
validation,patches_292.xml,200,200,patches,66,174,107,200,86.5,187.0,41,26,1.5769230769230769
validation,patches_293.xml,200,200,patches,119,54,187,199,153.0,126.5,68,145,0.4689655172413793
validation,patches_293.xml,200,200,patches,135,10,175,85,155.0,47.5,40,75,0.5333333333333333
validation,patches_294.xml,200,200,patches,3,1,67,191,35.0,96.0,64,190,0.3368421052631579
validation,patches_294.xml,200,200,patches,131,67,196,198,163.5,132.5,65,131,0.4961832061068702
validation,patches_295.xml,200,200,patches,6,1,85,191,45.5,96.0,79,190,0.41578947368421054
validation,patches_295.xml,200,200,patches,144,1,200,124,172.0,62.5,56,123,0.45528455284552843
validation,patches_295.xml,200,200,patches,143,118,183,198,163.0,158.0,40,80,0.5
validation,patches_296.xml,200,200,patches,26,1,92,79,59.0,40.0,66,78,0.8461538461538461
validation,patches_296.xml,200,200,patches,116,1,182,70,149.0,35.5,66,69,0.9565217391304348
validation,patches_296.xml,200,200,patches,114,85,178,192,146.0,138.5,64,107,0.5981308411214953
validation,patches_297.xml,200,200,patches,8,27,90,193,49.0,110.0,82,166,0.4939759036144578
validation,patches_297.xml,200,200,patches,135,79,199,195,167.0,137.0,64,116,0.5517241379310345
validation,patches_297.xml,200,200,patches,142,1,198,74,170.0,37.5,56,73,0.7671232876712328
validation,patches_298.xml,200,200,patches,2,84,51,166,26.5,125.0,49,82,0.5975609756097561
validation,patches_298.xml,200,200,patches,133,45,194,108,163.5,76.5,61,63,0.9682539682539683
validation,patches_298.xml,200,200,patches,164,164,197,194,180.5,179.0,33,30,1.1
validation,patches_298.xml,200,200,patches,41,90,83,143,62.0,116.5,42,53,0.7924528301886793
validation,patches_299.xml,200,200,patches,89,26,170,181,129.5,103.5,81,155,0.5225806451612903
validation,patches_299.xml,200,200,patches,1,1,46,34,23.5,17.5,45,33,1.3636363636363635
validation,patches_299.xml,200,200,patches,1,73,54,200,27.5,136.5,53,127,0.41732283464566927
validation,patches_300.xml,200,200,patches,41,64,98,161,69.5,112.5,57,97,0.5876288659793815
validation,patches_300.xml,200,200,patches,47,15,99,86,73.0,50.5,52,71,0.7323943661971831
validation,pitted_surface_241.xml,200,200,pitted_surface,6,17,166,200,86.0,108.5,160,183,0.8743169398907104
validation,pitted_surface_242.xml,200,200,pitted_surface,1,18,89,188,45.0,103.0,88,170,0.5176470588235295
validation,pitted_surface_242.xml,200,200,pitted_surface,61,1,200,177,130.5,89.0,139,176,0.7897727272727273
validation,pitted_surface_243.xml,200,200,pitted_surface,6,1,195,196,100.5,98.5,189,195,0.9692307692307692
validation,pitted_surface_244.xml,200,200,pitted_surface,17,33,168,192,92.5,112.5,151,159,0.949685534591195
validation,pitted_surface_245.xml,200,200,pitted_surface,61,2,198,198,129.5,100.0,137,196,0.6989795918367347
validation,pitted_surface_245.xml,200,200,pitted_surface,15,5,101,192,58.0,98.5,86,187,0.45989304812834225
validation,pitted_surface_245.xml,200,200,patches,2,1,41,46,21.5,23.5,39,45,0.8666666666666667
validation,pitted_surface_246.xml,200,200,pitted_surface,76,2,198,198,137.0,100.0,122,196,0.6224489795918368
validation,pitted_surface_246.xml,200,200,pitted_surface,4,2,110,197,57.0,99.5,106,195,0.5435897435897435
validation,pitted_surface_247.xml,200,200,pitted_surface,8,6,111,161,59.5,83.5,103,155,0.6645161290322581
validation,pitted_surface_247.xml,200,200,patches,20,171,73,200,46.5,185.5,53,29,1.8275862068965518
validation,pitted_surface_248.xml,200,200,pitted_surface,48,1,200,200,124.0,100.5,152,199,0.7638190954773869
validation,pitted_surface_249.xml,200,200,pitted_surface,1,3,198,198,99.5,100.5,197,195,1.0102564102564102
validation,pitted_surface_250.xml,200,200,pitted_surface,4,9,197,199,100.5,104.0,193,190,1.0157894736842106
validation,pitted_surface_251.xml,200,200,pitted_surface,1,1,162,198,81.5,99.5,161,197,0.817258883248731
validation,pitted_surface_252.xml,200,200,pitted_surface,57,1,198,198,127.5,99.5,141,197,0.7157360406091371
validation,pitted_surface_253.xml,200,200,pitted_surface,63,1,200,198,131.5,99.5,137,197,0.6954314720812182
validation,pitted_surface_254.xml,200,200,pitted_surface,12,2,199,198,105.5,100.0,187,196,0.9540816326530612
validation,pitted_surface_255.xml,200,200,pitted_surface,9,1,198,196,103.5,98.5,189,195,0.9692307692307692
validation,pitted_surface_256.xml,200,200,pitted_surface,95,1,200,198,147.5,99.5,105,197,0.5329949238578681
validation,pitted_surface_256.xml,200,200,pitted_surface,2,1,99,198,50.5,99.5,97,197,0.49238578680203043
validation,pitted_surface_257.xml,200,200,pitted_surface,80,3,197,197,138.5,100.0,117,194,0.6030927835051546
validation,pitted_surface_258.xml,200,200,pitted_surface,33,3,197,195,115.0,99.0,164,192,0.8541666666666666
validation,pitted_surface_259.xml,200,200,pitted_surface,4,3,199,197,101.5,100.0,195,194,1.0051546391752577
validation,pitted_surface_260.xml,200,200,pitted_surface,1,1,148,198,74.5,99.5,147,197,0.7461928934010152
validation,pitted_surface_261.xml,200,200,pitted_surface,51,6,197,157,124.0,81.5,146,151,0.9668874172185431
validation,pitted_surface_261.xml,200,200,patches,1,104,59,199,30.0,151.5,58,95,0.6105263157894737
validation,pitted_surface_262.xml,200,200,pitted_surface,13,3,198,172,105.5,87.5,185,169,1.0946745562130178
validation,pitted_surface_263.xml,200,200,pitted_surface,13,7,198,200,105.5,103.5,185,193,0.9585492227979274
validation,pitted_surface_264.xml,200,200,pitted_surface,1,1,196,149,98.5,75.0,195,148,1.3175675675675675
validation,pitted_surface_265.xml,200,200,pitted_surface,2,1,196,184,99.0,92.5,194,183,1.0601092896174864
validation,pitted_surface_266.xml,200,200,pitted_surface,75,15,196,187,135.5,101.0,121,172,0.7034883720930233
validation,pitted_surface_266.xml,200,200,pitted_surface,1,1,44,74,22.5,37.5,43,73,0.589041095890411
validation,pitted_surface_266.xml,200,200,pitted_surface,1,69,48,177,24.5,123.0,47,108,0.4351851851851852
validation,pitted_surface_267.xml,200,200,pitted_surface,49,3,200,173,124.5,88.0,151,170,0.888235294117647
validation,pitted_surface_267.xml,200,200,pitted_surface,4,10,90,185,47.0,97.5,86,175,0.49142857142857144
validation,pitted_surface_268.xml,200,200,pitted_surface,31,2,197,191,114.0,96.5,166,189,0.8783068783068783
validation,pitted_surface_268.xml,200,200,pitted_surface,8,29,77,199,42.5,114.0,69,170,0.40588235294117647
validation,pitted_surface_269.xml,200,200,pitted_surface,5,13,149,188,77.0,100.5,144,175,0.8228571428571428
validation,pitted_surface_269.xml,200,200,pitted_surface,141,1,197,199,169.0,100.0,56,198,0.2828282828282828
validation,pitted_surface_270.xml,200,200,pitted_surface,53,3,196,197,124.5,100.0,143,194,0.7371134020618557
validation,pitted_surface_271.xml,200,200,pitted_surface,5,7,124,185,64.5,96.0,119,178,0.6685393258426966
validation,pitted_surface_271.xml,200,200,pitted_surface,101,1,184,194,142.5,97.5,83,193,0.43005181347150256
validation,pitted_surface_272.xml,200,200,pitted_surface,5,1,126,194,65.5,97.5,121,193,0.6269430051813472
validation,pitted_surface_272.xml,200,200,pitted_surface,115,3,199,198,157.0,100.5,84,195,0.4307692307692308
validation,pitted_surface_272.xml,200,200,patches,96,1,143,31,119.5,16.0,47,30,1.5666666666666667
validation,pitted_surface_273.xml,200,200,pitted_surface,56,16,199,200,127.5,108.0,143,184,0.7771739130434783
validation,pitted_surface_274.xml,200,200,pitted_surface,10,7,198,198,104.0,102.5,188,191,0.9842931937172775
validation,pitted_surface_275.xml,200,200,pitted_surface,23,1,174,192,98.5,96.5,151,191,0.7905759162303665
validation,pitted_surface_276.xml,200,200,pitted_surface,1,1,120,193,60.5,97.0,119,192,0.6197916666666666
validation,pitted_surface_276.xml,200,200,patches,95,124,171,199,133.0,161.5,76,75,1.0133333333333334
validation,pitted_surface_276.xml,200,200,patches,118,1,183,74,150.5,37.5,65,73,0.8904109589041096
validation,pitted_surface_277.xml,200,200,pitted_surface,22,6,181,194,101.5,100.0,159,188,0.8457446808510638
validation,pitted_surface_277.xml,200,200,patches,2,44,35,69,18.5,56.5,33,25,1.32
validation,pitted_surface_278.xml,200,200,pitted_surface,42,14,189,194,115.5,104.0,147,180,0.8166666666666667
validation,pitted_surface_279.xml,200,200,pitted_surface,64,14,200,193,132.0,103.5,136,179,0.7597765363128491
validation,pitted_surface_279.xml,200,200,inclusion,45,33,67,63,56.0,48.0,22,30,0.7333333333333333
validation,pitted_surface_279.xml,200,200,patches,1,112,27,158,14.0,135.0,26,46,0.5652173913043478
validation,pitted_surface_280.xml,200,200,pitted_surface,8,8,93,183,50.5,95.5,85,175,0.4857142857142857
validation,pitted_surface_280.xml,200,200,pitted_surface,75,17,138,155,106.5,86.0,63,138,0.45652173913043476
validation,pitted_surface_280.xml,200,200,pitted_surface,136,30,200,198,168.0,114.0,64,168,0.38095238095238093
validation,pitted_surface_281.xml,200,200,pitted_surface,52,5,200,192,126.0,98.5,148,187,0.7914438502673797
validation,pitted_surface_281.xml,200,200,inclusion,10,12,38,198,24.0,105.0,28,186,0.15053763440860216
validation,pitted_surface_282.xml,200,200,pitted_surface,9,11,103,167,56.0,89.0,94,156,0.6025641025641025
validation,pitted_surface_282.xml,200,200,pitted_surface,71,18,192,189,131.5,103.5,121,171,0.7076023391812866
validation,pitted_surface_283.xml,200,200,pitted_surface,2,9,185,198,93.5,103.5,183,189,0.9682539682539683
validation,pitted_surface_284.xml,200,200,pitted_surface,49,1,198,195,123.5,98.0,149,194,0.7680412371134021
validation,pitted_surface_284.xml,200,200,pitted_surface,2,23,57,198,29.5,110.5,55,175,0.3142857142857143
validation,pitted_surface_285.xml,200,200,pitted_surface,19,21,150,191,84.5,106.0,131,170,0.7705882352941177
validation,pitted_surface_286.xml,200,200,pitted_surface,26,2,198,192,112.0,97.0,172,190,0.9052631578947369
validation,pitted_surface_287.xml,200,200,pitted_surface,12,1,199,191,105.5,96.0,187,190,0.9842105263157894
validation,pitted_surface_288.xml,200,200,pitted_surface,22,1,199,141,110.5,71.0,177,140,1.2642857142857142
validation,pitted_surface_289.xml,200,200,pitted_surface,40,18,198,200,119.0,109.0,158,182,0.8681318681318682
validation,pitted_surface_289.xml,200,200,pitted_surface,2,31,85,199,43.5,115.0,83,168,0.49404761904761907
validation,pitted_surface_290.xml,200,200,pitted_surface,1,16,180,200,90.5,108.0,179,184,0.9728260869565217
validation,pitted_surface_290.xml,200,200,pitted_surface,133,1,198,126,165.5,63.5,65,125,0.52
validation,pitted_surface_290.xml,200,200,pitted_surface,11,1,129,44,70.0,22.5,118,43,2.744186046511628
validation,pitted_surface_291.xml,200,200,pitted_surface,1,1,179,195,90.0,98.0,178,194,0.9175257731958762
validation,pitted_surface_291.xml,200,200,patches,170,1,198,66,184.0,33.5,28,65,0.4307692307692308
validation,pitted_surface_292.xml,200,200,pitted_surface,46,1,200,138,123.0,69.5,154,137,1.1240875912408759
validation,pitted_surface_292.xml,200,200,pitted_surface,73,107,197,191,135.0,149.0,124,84,1.4761904761904763
validation,pitted_surface_292.xml,200,200,patches,26,136,71,198,48.5,167.0,45,62,0.7258064516129032
validation,pitted_surface_292.xml,200,200,patches,1,43,52,126,26.5,84.5,51,83,0.6144578313253012
validation,pitted_surface_293.xml,200,200,pitted_surface,17,1,199,192,108.0,96.5,182,191,0.9528795811518325
validation,pitted_surface_294.xml,200,200,pitted_surface,66,66,197,192,131.5,129.0,131,126,1.0396825396825398
validation,pitted_surface_294.xml,200,200,pitted_surface,1,90,64,199,32.5,144.5,63,109,0.5779816513761468
validation,pitted_surface_294.xml,200,200,patches,51,38,78,74,64.5,56.0,27,36,0.75
validation,pitted_surface_295.xml,200,200,pitted_surface,52,6,200,156,126.0,81.0,148,150,0.9866666666666667
validation,pitted_surface_295.xml,200,200,patches,9,67,55,131,32.0,99.0,46,64,0.71875
validation,pitted_surface_296.xml,200,200,pitted_surface,3,3,112,198,57.5,100.5,109,195,0.558974358974359
validation,pitted_surface_296.xml,200,200,pitted_surface,101,1,199,188,150.0,94.5,98,187,0.5240641711229946
validation,pitted_surface_296.xml,200,200,patches,92,104,141,177,116.5,140.5,49,73,0.6712328767123288
validation,pitted_surface_297.xml,200,200,pitted_surface,1,4,139,198,70.0,101.0,138,194,0.711340206185567
validation,pitted_surface_298.xml,200,200,pitted_surface,46,1,163,182,104.5,91.5,117,181,0.6464088397790055
validation,pitted_surface_298.xml,200,200,pitted_surface,166,12,197,142,181.5,77.0,31,130,0.23846153846153847
validation,pitted_surface_299.xml,200,200,pitted_surface,35,14,112,176,73.5,95.0,77,162,0.47530864197530864
validation,pitted_surface_299.xml,200,200,pitted_surface,116,21,199,200,157.5,110.5,83,179,0.46368715083798884
validation,pitted_surface_299.xml,200,200,pitted_surface,2,12,38,178,20.0,95.0,36,166,0.21686746987951808
validation,pitted_surface_300.xml,200,200,pitted_surface,135,7,198,200,166.5,103.5,63,193,0.32642487046632124
validation,pitted_surface_300.xml,200,200,pitted_surface,1,1,153,198,77.0,99.5,152,197,0.7715736040609137
validation,rolled-in_scale_241.xml,200,200,rolled-in_scale,62,3,156,100,109.0,51.5,94,97,0.9690721649484536
validation,rolled-in_scale_241.xml,200,200,rolled-in_scale,53,104,155,196,104.0,150.0,102,92,1.108695652173913
validation,rolled-in_scale_242.xml,200,200,rolled-in_scale,38,71,132,197,85.0,134.0,94,126,0.746031746031746
validation,rolled-in_scale_242.xml,200,200,rolled-in_scale,16,11,125,116,70.5,63.5,109,105,1.0380952380952382
validation,rolled-in_scale_243.xml,200,200,rolled-in_scale,58,26,129,192,93.5,109.0,71,166,0.42771084337349397
validation,rolled-in_scale_244.xml,200,200,rolled-in_scale,25,30,83,136,54.0,83.0,58,106,0.5471698113207547
validation,rolled-in_scale_244.xml,200,200,rolled-in_scale,103,80,176,198,139.5,139.0,73,118,0.6186440677966102
validation,rolled-in_scale_244.xml,200,200,rolled-in_scale,99,2,178,120,138.5,61.0,79,118,0.6694915254237288
validation,rolled-in_scale_245.xml,200,200,rolled-in_scale,6,80,138,199,72.0,139.5,132,119,1.1092436974789917
validation,rolled-in_scale_245.xml,200,200,rolled-in_scale,32,31,152,106,92.0,68.5,120,75,1.6
validation,rolled-in_scale_246.xml,200,200,rolled-in_scale,34,59,136,180,85.0,119.5,102,121,0.8429752066115702
validation,rolled-in_scale_246.xml,200,200,rolled-in_scale,2,3,118,39,60.0,21.0,116,36,3.2222222222222223
validation,rolled-in_scale_247.xml,200,200,rolled-in_scale,10,25,79,108,44.5,66.5,69,83,0.8313253012048193
validation,rolled-in_scale_247.xml,200,200,rolled-in_scale,42,99,89,183,65.5,141.0,47,84,0.5595238095238095
validation,rolled-in_scale_248.xml,200,200,rolled-in_scale,56,2,113,66,84.5,34.0,57,64,0.890625
validation,rolled-in_scale_248.xml,200,200,rolled-in_scale,44,73,161,198,102.5,135.5,117,125,0.936
validation,rolled-in_scale_249.xml,200,200,rolled-in_scale,22,62,157,192,89.5,127.0,135,130,1.0384615384615385
validation,rolled-in_scale_250.xml,200,200,rolled-in_scale,91,99,141,198,116.0,148.5,50,99,0.5050505050505051
validation,rolled-in_scale_250.xml,200,200,rolled-in_scale,152,39,199,200,175.5,119.5,47,161,0.2919254658385093
validation,rolled-in_scale_250.xml,200,200,rolled-in_scale,91,2,136,39,113.5,20.5,45,37,1.2162162162162162
validation,rolled-in_scale_251.xml,200,200,rolled-in_scale,1,58,58,200,29.5,129.0,57,142,0.4014084507042254
validation,rolled-in_scale_251.xml,200,200,rolled-in_scale,1,1,48,32,24.5,16.5,47,31,1.5161290322580645
validation,rolled-in_scale_252.xml,200,200,rolled-in_scale,49,67,155,199,102.0,133.0,106,132,0.803030303030303
validation,rolled-in_scale_252.xml,200,200,rolled-in_scale,60,2,123,61,91.5,31.5,63,59,1.0677966101694916
validation,rolled-in_scale_253.xml,200,200,rolled-in_scale,1,6,122,125,61.5,65.5,121,119,1.0168067226890756
validation,rolled-in_scale_254.xml,200,200,rolled-in_scale,55,110,146,198,100.5,154.0,91,88,1.0340909090909092
validation,rolled-in_scale_255.xml,200,200,rolled-in_scale,1,42,69,197,35.0,119.5,68,155,0.43870967741935485
validation,rolled-in_scale_255.xml,200,200,rolled-in_scale,72,27,113,129,92.5,78.0,41,102,0.4019607843137255
validation,rolled-in_scale_255.xml,200,200,rolled-in_scale,5,5,69,68,37.0,36.5,64,63,1.0158730158730158
validation,rolled-in_scale_255.xml,200,200,rolled-in_scale,153,50,195,83,174.0,66.5,42,33,1.2727272727272727
validation,rolled-in_scale_256.xml,200,200,rolled-in_scale,19,45,111,199,65.0,122.0,92,154,0.5974025974025974
validation,rolled-in_scale_257.xml,200,200,rolled-in_scale,1,37,68,200,34.5,118.5,67,163,0.4110429447852761
validation,rolled-in_scale_257.xml,200,200,rolled-in_scale,100,107,156,198,128.0,152.5,56,91,0.6153846153846154
validation,rolled-in_scale_257.xml,200,200,rolled-in_scale,101,31,166,109,133.5,70.0,65,78,0.8333333333333334
validation,rolled-in_scale_258.xml,200,200,rolled-in_scale,8,59,143,200,75.5,129.5,135,141,0.9574468085106383
validation,rolled-in_scale_259.xml,200,200,rolled-in_scale,3,61,125,199,64.0,130.0,122,138,0.8840579710144928
validation,rolled-in_scale_259.xml,200,200,rolled-in_scale,68,97,200,190,134.0,143.5,132,93,1.4193548387096775
validation,rolled-in_scale_259.xml,200,200,rolled-in_scale,52,1,111,36,81.5,18.5,59,35,1.6857142857142857
validation,rolled-in_scale_259.xml,200,200,rolled-in_scale,104,1,182,40,143.0,20.5,78,39,2.0
validation,rolled-in_scale_260.xml,200,200,rolled-in_scale,115,95,180,197,147.5,146.0,65,102,0.6372549019607843
validation,rolled-in_scale_260.xml,200,200,rolled-in_scale,1,30,112,121,56.5,75.5,111,91,1.2197802197802199
validation,rolled-in_scale_260.xml,200,200,rolled-in_scale,92,1,187,77,139.5,39.0,95,76,1.25
validation,rolled-in_scale_261.xml,200,200,rolled-in_scale,6,7,107,131,56.5,69.0,101,124,0.8145161290322581
validation,rolled-in_scale_262.xml,200,200,rolled-in_scale,12,45,121,180,66.5,112.5,109,135,0.8074074074074075
validation,rolled-in_scale_263.xml,200,200,rolled-in_scale,61,83,172,196,116.5,139.5,111,113,0.9823008849557522
validation,rolled-in_scale_263.xml,200,200,rolled-in_scale,35,2,181,94,108.0,48.0,146,92,1.5869565217391304
validation,rolled-in_scale_264.xml,200,200,rolled-in_scale,32,73,140,180,86.0,126.5,108,107,1.0093457943925233
validation,rolled-in_scale_264.xml,200,200,rolled-in_scale,46,3,152,64,99.0,33.5,106,61,1.7377049180327868
validation,rolled-in_scale_264.xml,200,200,rolled-in_scale,146,56,197,189,171.5,122.5,51,133,0.38345864661654133
validation,rolled-in_scale_265.xml,200,200,rolled-in_scale,1,33,54,184,27.5,108.5,53,151,0.3509933774834437
validation,rolled-in_scale_265.xml,200,200,rolled-in_scale,134,91,194,166,164.0,128.5,60,75,0.8
validation,rolled-in_scale_266.xml,200,200,rolled-in_scale,1,22,80,151,40.5,86.5,79,129,0.6124031007751938
validation,rolled-in_scale_266.xml,200,200,rolled-in_scale,121,41,195,93,158.0,67.0,74,52,1.4230769230769231
validation,rolled-in_scale_267.xml,200,200,rolled-in_scale,102,53,146,107,124.0,80.0,44,54,0.8148148148148148
validation,rolled-in_scale_267.xml,200,200,rolled-in_scale,75,1,193,35,134.0,18.0,118,34,3.4705882352941178
validation,rolled-in_scale_267.xml,200,200,rolled-in_scale,76,134,197,193,136.5,163.5,121,59,2.0508474576271185
validation,rolled-in_scale_268.xml,200,200,rolled-in_scale,15,117,191,194,103.0,155.5,176,77,2.2857142857142856
validation,rolled-in_scale_268.xml,200,200,rolled-in_scale,25,27,166,158,95.5,92.5,141,131,1.0763358778625953
validation,rolled-in_scale_269.xml,200,200,rolled-in_scale,112,59,191,118,151.5,88.5,79,59,1.3389830508474576
validation,rolled-in_scale_270.xml,200,200,rolled-in_scale,18,133,122,197,70.0,165.0,104,64,1.625
validation,rolled-in_scale_270.xml,200,200,rolled-in_scale,23,5,114,73,68.5,39.0,91,68,1.338235294117647
validation,rolled-in_scale_271.xml,200,200,rolled-in_scale,33,1,101,39,67.0,20.0,68,38,1.7894736842105263
validation,rolled-in_scale_271.xml,200,200,rolled-in_scale,70,122,127,172,98.5,147.0,57,50,1.14
validation,rolled-in_scale_272.xml,200,200,rolled-in_scale,41,86,146,199,93.5,142.5,105,113,0.9292035398230089
validation,rolled-in_scale_272.xml,200,200,rolled-in_scale,101,1,160,91,130.5,46.0,59,90,0.6555555555555556
validation,rolled-in_scale_273.xml,200,200,rolled-in_scale,18,103,105,187,61.5,145.0,87,84,1.0357142857142858
validation,rolled-in_scale_273.xml,200,200,rolled-in_scale,10,1,99,88,54.5,44.5,89,87,1.0229885057471264
validation,rolled-in_scale_274.xml,200,200,rolled-in_scale,1,34,123,108,62.0,71.0,122,74,1.6486486486486487
validation,rolled-in_scale_274.xml,200,200,rolled-in_scale,152,129,198,198,175.0,163.5,46,69,0.6666666666666666
validation,rolled-in_scale_274.xml,200,200,rolled-in_scale,32,2,104,52,68.0,27.0,72,50,1.44
validation,rolled-in_scale_274.xml,200,200,rolled-in_scale,3,84,114,163,58.5,123.5,111,79,1.4050632911392404
validation,rolled-in_scale_275.xml,200,200,rolled-in_scale,56,139,115,199,85.5,169.0,59,60,0.9833333333333333
validation,rolled-in_scale_275.xml,200,200,rolled-in_scale,144,116,199,192,171.5,154.0,55,76,0.7236842105263158
validation,rolled-in_scale_275.xml,200,200,rolled-in_scale,43,6,116,114,79.5,60.0,73,108,0.6759259259259259
validation,rolled-in_scale_276.xml,200,200,rolled-in_scale,78,1,133,47,105.5,24.0,55,46,1.1956521739130435
validation,rolled-in_scale_276.xml,200,200,rolled-in_scale,1,32,49,76,25.0,54.0,48,44,1.0909090909090908
validation,rolled-in_scale_277.xml,200,200,rolled-in_scale,1,130,67,196,34.0,163.0,66,66,1.0
validation,rolled-in_scale_277.xml,200,200,rolled-in_scale,150,26,200,128,175.0,77.0,50,102,0.49019607843137253
validation,rolled-in_scale_277.xml,200,200,rolled-in_scale,107,25,149,71,128.0,48.0,42,46,0.9130434782608695
validation,rolled-in_scale_278.xml,200,200,rolled-in_scale,1,36,54,179,27.5,107.5,53,143,0.3706293706293706
validation,rolled-in_scale_278.xml,200,200,rolled-in_scale,57,45,136,164,96.5,104.5,79,119,0.6638655462184874
validation,rolled-in_scale_278.xml,200,200,rolled-in_scale,97,128,196,197,146.5,162.5,99,69,1.434782608695652
validation,rolled-in_scale_279.xml,200,200,rolled-in_scale,33,60,115,195,74.0,127.5,82,135,0.6074074074074074
validation,rolled-in_scale_279.xml,200,200,rolled-in_scale,120,38,189,150,154.5,94.0,69,112,0.6160714285714286
validation,rolled-in_scale_280.xml,200,200,rolled-in_scale,65,113,162,198,113.5,155.5,97,85,1.1411764705882352
validation,rolled-in_scale_280.xml,200,200,rolled-in_scale,80,28,150,91,115.0,59.5,70,63,1.1111111111111112
validation,rolled-in_scale_281.xml,200,200,rolled-in_scale,96,69,151,198,123.5,133.5,55,129,0.4263565891472868
validation,rolled-in_scale_281.xml,200,200,rolled-in_scale,96,1,142,62,119.0,31.5,46,61,0.7540983606557377
validation,rolled-in_scale_281.xml,200,200,rolled-in_scale,120,166,166,200,143.0,183.0,46,34,1.3529411764705883
validation,rolled-in_scale_282.xml,200,200,rolled-in_scale,31,91,161,200,96.0,145.5,130,109,1.1926605504587156
validation,rolled-in_scale_282.xml,200,200,rolled-in_scale,109,1,161,50,135.0,25.5,52,49,1.0612244897959184
validation,rolled-in_scale_283.xml,200,200,rolled-in_scale,102,85,170,197,136.0,141.0,68,112,0.6071428571428571
validation,rolled-in_scale_283.xml,200,200,rolled-in_scale,30,3,176,87,103.0,45.0,146,84,1.7380952380952381
validation,rolled-in_scale_283.xml,200,200,rolled-in_scale,30,141,75,196,52.5,168.5,45,55,0.8181818181818182
validation,rolled-in_scale_284.xml,200,200,rolled-in_scale,55,98,131,199,93.0,148.5,76,101,0.7524752475247525
validation,rolled-in_scale_285.xml,200,200,rolled-in_scale,35,1,171,58,103.0,29.5,136,57,2.3859649122807016
validation,rolled-in_scale_285.xml,200,200,rolled-in_scale,40,61,158,191,99.0,126.0,118,130,0.9076923076923077
validation,rolled-in_scale_286.xml,200,200,rolled-in_scale,36,103,152,171,94.0,137.0,116,68,1.7058823529411764
validation,rolled-in_scale_286.xml,200,200,rolled-in_scale,30,15,150,95,90.0,55.0,120,80,1.5
validation,rolled-in_scale_287.xml,200,200,rolled-in_scale,3,69,101,199,52.0,134.0,98,130,0.7538461538461538
validation,rolled-in_scale_287.xml,200,200,rolled-in_scale,15,1,87,78,51.0,39.5,72,77,0.935064935064935
validation,rolled-in_scale_288.xml,200,200,rolled-in_scale,45,13,151,198,98.0,105.5,106,185,0.572972972972973
validation,rolled-in_scale_288.xml,200,200,rolled-in_scale,59,6,162,92,110.5,49.0,103,86,1.197674418604651
validation,rolled-in_scale_289.xml,200,200,rolled-in_scale,68,61,195,178,131.5,119.5,127,117,1.0854700854700854
validation,rolled-in_scale_289.xml,200,200,rolled-in_scale,86,1,183,83,134.5,42.0,97,82,1.1829268292682926
validation,rolled-in_scale_290.xml,200,200,rolled-in_scale,1,1,126,77,63.5,39.0,125,76,1.644736842105263
validation,rolled-in_scale_290.xml,200,200,rolled-in_scale,23,113,120,198,71.5,155.5,97,85,1.1411764705882352
validation,rolled-in_scale_291.xml,200,200,rolled-in_scale,130,72,199,197,164.5,134.5,69,125,0.552
validation,rolled-in_scale_291.xml,200,200,rolled-in_scale,85,1,187,28,136.0,14.5,102,27,3.7777777777777777
validation,rolled-in_scale_291.xml,200,200,rolled-in_scale,80,48,143,92,111.5,70.0,63,44,1.4318181818181819
validation,rolled-in_scale_292.xml,200,200,rolled-in_scale,24,124,162,200,93.0,162.0,138,76,1.8157894736842106
validation,rolled-in_scale_292.xml,200,200,rolled-in_scale,70,41,143,132,106.5,86.5,73,91,0.8021978021978022
validation,rolled-in_scale_292.xml,200,200,rolled-in_scale,95,1,146,51,120.5,26.0,51,50,1.02
validation,rolled-in_scale_292.xml,200,200,rolled-in_scale,47,11,90,46,68.5,28.5,43,35,1.2285714285714286
validation,rolled-in_scale_293.xml,200,200,rolled-in_scale,40,3,167,59,103.5,31.0,127,56,2.267857142857143
validation,rolled-in_scale_293.xml,200,200,rolled-in_scale,39,110,164,191,101.5,150.5,125,81,1.5432098765432098
validation,rolled-in_scale_294.xml,200,200,rolled-in_scale,29,21,112,179,70.5,100.0,83,158,0.5253164556962026
validation,rolled-in_scale_294.xml,200,200,rolled-in_scale,116,98,163,199,139.5,148.5,47,101,0.46534653465346537
validation,rolled-in_scale_295.xml,200,200,rolled-in_scale,52,109,167,198,109.5,153.5,115,89,1.2921348314606742
validation,rolled-in_scale_295.xml,200,200,rolled-in_scale,109,1,163,96,136.0,48.5,54,95,0.5684210526315789
validation,rolled-in_scale_296.xml,200,200,rolled-in_scale,2,36,112,191,57.0,113.5,110,155,0.7096774193548387
validation,rolled-in_scale_297.xml,200,200,rolled-in_scale,54,45,126,197,90.0,121.0,72,152,0.47368421052631576
validation,rolled-in_scale_297.xml,200,200,rolled-in_scale,104,96,168,177,136.0,136.5,64,81,0.7901234567901234
validation,rolled-in_scale_298.xml,200,200,rolled-in_scale,73,147,141,199,107.0,173.0,68,52,1.3076923076923077
validation,rolled-in_scale_299.xml,200,200,rolled-in_scale,41,82,153,198,97.0,140.0,112,116,0.9655172413793104
validation,rolled-in_scale_299.xml,200,200,rolled-in_scale,46,1,107,37,76.5,19.0,61,36,1.6944444444444444
validation,rolled-in_scale_300.xml,200,200,rolled-in_scale,53,126,125,200,89.0,163.0,72,74,0.972972972972973
validation,rolled-in_scale_300.xml,200,200,rolled-in_scale,63,11,108,77,85.5,44.0,45,66,0.6818181818181818
validation,scratches_241.xml,200,200,scratches,1,25,199,50,100.0,37.5,198,25,7.92
validation,scratches_241.xml,200,200,scratches,1,106,161,136,81.0,121.0,160,30,5.333333333333333
validation,scratches_242.xml,200,200,scratches,7,35,108,52,57.5,43.5,101,17,5.9411764705882355
validation,scratches_242.xml,200,200,scratches,82,156,199,171,140.5,163.5,117,15,7.8
validation,scratches_242.xml,200,200,inclusion,2,169,27,195,14.5,182.0,25,26,0.9615384615384616
validation,scratches_243.xml,200,200,scratches,49,12,200,39,124.5,25.5,151,27,5.592592592592593
validation,scratches_243.xml,200,200,scratches,24,147,179,165,101.5,156.0,155,18,8.61111111111111
validation,scratches_243.xml,200,200,scratches,123,45,198,59,160.5,52.0,75,14,5.357142857142857
validation,scratches_244.xml,200,200,scratches,2,42,199,61,100.5,51.5,197,19,10.368421052631579
validation,scratches_244.xml,200,200,scratches,84,88,196,111,140.0,99.5,112,23,4.869565217391305
validation,scratches_245.xml,200,200,scratches,1,70,99,81,50.0,75.5,98,11,8.909090909090908
validation,scratches_245.xml,200,200,scratches,3,18,198,31,100.5,24.5,195,13,15.0
validation,scratches_246.xml,200,200,scratches,2,157,180,171,91.0,164.0,178,14,12.714285714285714
validation,scratches_247.xml,200,200,scratches,117,37,133,169,125.0,103.0,16,132,0.12121212121212122
validation,scratches_248.xml,200,200,scratches,36,176,146,195,91.0,185.5,110,19,5.7894736842105265
validation,scratches_248.xml,200,200,scratches,75,21,197,36,136.0,28.5,122,15,8.133333333333333
validation,scratches_249.xml,200,200,scratches,27,92,199,112,113.0,102.0,172,20,8.6
validation,scratches_250.xml,200,200,scratches,2,82,199,107,100.5,94.5,197,25,7.88
validation,scratches_250.xml,200,200,scratches,33,175,180,197,106.5,186.0,147,22,6.681818181818182
validation,scratches_251.xml,200,200,scratches,1,155,192,188,96.5,171.5,191,33,5.787878787878788
validation,scratches_251.xml,200,200,scratches,74,128,190,151,132.0,139.5,116,23,5.043478260869565
validation,scratches_252.xml,200,200,scratches,1,78,199,111,100.0,94.5,198,33,6.0
validation,scratches_253.xml,200,200,scratches,1,135,199,167,100.0,151.0,198,32,6.1875
validation,scratches_254.xml,200,200,scratches,4,131,199,153,101.5,142.0,195,22,8.863636363636363
validation,scratches_255.xml,200,200,scratches,1,138,199,166,100.0,152.0,198,28,7.071428571428571
validation,scratches_256.xml,200,200,scratches,1,90,199,124,100.0,107.0,198,34,5.823529411764706
validation,scratches_257.xml,200,200,scratches,1,45,200,77,100.5,61.0,199,32,6.21875
validation,scratches_258.xml,200,200,scratches,1,128,200,161,100.5,144.5,199,33,6.03030303030303
validation,scratches_259.xml,200,200,scratches,1,85,200,121,100.5,103.0,199,36,5.527777777777778
validation,scratches_260.xml,200,200,scratches,1,24,200,50,100.5,37.0,199,26,7.653846153846154
validation,scratches_260.xml,200,200,scratches,96,73,199,85,147.5,79.0,103,12,8.583333333333334
validation,scratches_261.xml,200,200,scratches,1,151,199,180,100.0,165.5,198,29,6.827586206896552
validation,scratches_262.xml,200,200,scratches,1,111,195,139,98.0,125.0,194,28,6.928571428571429
validation,scratches_263.xml,200,200,scratches,1,25,198,50,99.5,37.5,197,25,7.88
validation,scratches_264.xml,200,200,scratches,34,71,200,104,117.0,87.5,166,33,5.03030303030303
validation,scratches_264.xml,200,200,scratches,1,116,198,147,99.5,131.5,197,31,6.354838709677419
validation,scratches_265.xml,200,200,scratches,1,166,181,194,91.0,180.0,180,28,6.428571428571429
validation,scratches_265.xml,200,200,scratches,2,120,200,151,101.0,135.5,198,31,6.387096774193548
validation,scratches_266.xml,200,200,scratches,1,181,87,193,44.0,187.0,86,12,7.166666666666667
validation,scratches_266.xml,200,200,scratches,1,139,198,159,99.5,149.0,197,20,9.85
validation,scratches_267.xml,200,200,scratches,1,141,119,160,60.0,150.5,118,19,6.2105263157894735
validation,scratches_267.xml,200,200,scratches,113,181,198,196,155.5,188.5,85,15,5.666666666666667
validation,scratches_268.xml,200,200,scratches,1,122,93,133,47.0,127.5,92,11,8.363636363636363
validation,scratches_268.xml,200,200,scratches,1,149,197,165,99.0,157.0,196,16,12.25
validation,scratches_269.xml,200,200,scratches,1,54,152,71,76.5,62.5,151,17,8.882352941176471
validation,scratches_269.xml,200,200,scratches,112,95,197,107,154.5,101.0,85,12,7.083333333333333
validation,scratches_269.xml,200,200,scratches,1,118,198,142,99.5,130.0,197,24,8.208333333333334
validation,scratches_270.xml,200,200,scratches,1,59,198,77,99.5,68.0,197,18,10.944444444444445
validation,scratches_270.xml,200,200,scratches,1,116,198,142,99.5,129.0,197,26,7.576923076923077
validation,scratches_271.xml,200,200,scratches,1,44,198,65,99.5,54.5,197,21,9.380952380952381
validation,scratches_271.xml,200,200,scratches,88,114,200,128,144.0,121.0,112,14,8.0
validation,scratches_271.xml,200,200,scratches,1,82,111,94,56.0,88.0,110,12,9.166666666666666
validation,scratches_271.xml,200,200,scratches,1,87,198,116,99.5,101.5,197,29,6.793103448275862
validation,scratches_272.xml,200,200,scratches,64,41,199,68,131.5,54.5,135,27,5.0
validation,scratches_272.xml,200,200,scratches,24,82,199,115,111.5,98.5,175,33,5.303030303030303
validation,scratches_273.xml,200,200,scratches,1,18,199,62,100.0,40.0,198,44,4.5
validation,scratches_273.xml,200,200,scratches,44,134,199,166,121.5,150.0,155,32,4.84375
validation,scratches_273.xml,200,200,scratches,1,182,199,198,100.0,190.0,198,16,12.375
validation,scratches_274.xml,200,200,scratches,1,38,199,68,100.0,53.0,198,30,6.6
validation,scratches_274.xml,200,200,scratches,1,133,198,163,99.5,148.0,197,30,6.566666666666666
validation,scratches_274.xml,200,200,scratches,1,187,199,198,100.0,192.5,198,11,18.0
validation,scratches_275.xml,200,200,scratches,1,16,150,33,75.5,24.5,149,17,8.764705882352942
validation,scratches_275.xml,200,200,scratches,123,57,199,69,161.0,63.0,76,12,6.333333333333333
validation,scratches_275.xml,200,200,scratches,1,86,200,101,100.5,93.5,199,15,13.266666666666667
validation,scratches_275.xml,200,200,scratches,1,166,199,198,100.0,182.0,198,32,6.1875
validation,scratches_276.xml,200,200,scratches,1,56,94,70,47.5,63.0,93,14,6.642857142857143
validation,scratches_276.xml,200,200,scratches,1,136,199,164,100.0,150.0,198,28,7.071428571428571
validation,scratches_277.xml,200,200,scratches,1,21,200,49,100.5,35.0,199,28,7.107142857142857
validation,scratches_278.xml,200,200,scratches,1,7,199,37,100.0,22.0,198,30,6.6
validation,scratches_278.xml,200,200,scratches,1,158,62,176,31.5,167.0,61,18,3.388888888888889
validation,scratches_278.xml,200,200,scratches,1,60,170,75,85.5,67.5,169,15,11.266666666666667
validation,scratches_279.xml,200,200,scratches,1,49,199,75,100.0,62.0,198,26,7.615384615384615
validation,scratches_279.xml,200,200,scratches,1,98,199,116,100.0,107.0,198,18,11.0
validation,scratches_280.xml,200,200,scratches,1,33,198,65,99.5,49.0,197,32,6.15625
validation,scratches_280.xml,200,200,scratches,1,83,199,99,100.0,91.0,198,16,12.375
validation,scratches_281.xml,200,200,scratches,40,16,199,41,119.5,28.5,159,25,6.36
validation,scratches_282.xml,200,200,scratches,4,154,199,176,101.5,165.0,195,22,8.863636363636363
validation,scratches_283.xml,200,200,scratches,1,130,171,153,86.0,141.5,170,23,7.391304347826087
validation,scratches_283.xml,200,200,scratches,12,11,188,37,100.0,24.0,176,26,6.769230769230769
validation,scratches_284.xml,200,200,scratches,1,100,123,124,62.0,112.0,122,24,5.083333333333333
validation,scratches_284.xml,200,200,scratches,151,108,199,124,175.0,116.0,48,16,3.0
validation,scratches_285.xml,200,200,scratches,1,47,141,68,71.0,57.5,140,21,6.666666666666667
validation,scratches_285.xml,200,200,scratches,140,50,199,70,169.5,60.0,59,20,2.95
validation,scratches_286.xml,200,200,scratches,1,104,150,121,75.5,112.5,149,17,8.764705882352942
validation,scratches_287.xml,200,200,scratches,156,1,187,199,171.5,100.0,31,198,0.15656565656565657
validation,scratches_288.xml,200,200,scratches,62,1,87,197,74.5,99.0,25,196,0.12755102040816327
validation,scratches_289.xml,200,200,scratches,114,2,132,198,123.0,100.0,18,196,0.09183673469387756
validation,scratches_290.xml,200,200,scratches,10,28,159,43,84.5,35.5,149,15,9.933333333333334
validation,scratches_290.xml,200,200,scratches,24,62,192,79,108.0,70.5,168,17,9.882352941176471
validation,scratches_290.xml,200,200,inclusion,1,157,57,177,29.0,167.0,56,20,2.8
validation,scratches_291.xml,200,200,scratches,1,127,196,150,98.5,138.5,195,23,8.478260869565217
validation,scratches_292.xml,200,200,scratches,1,101,200,152,100.5,126.5,199,51,3.9019607843137254
validation,scratches_292.xml,200,200,scratches,1,163,194,177,97.5,170.0,193,14,13.785714285714286
validation,scratches_293.xml,200,200,scratches,77,173,194,189,135.5,181.0,117,16,7.3125
validation,scratches_293.xml,200,200,scratches,20,87,104,114,62.0,100.5,84,27,3.111111111111111
validation,scratches_294.xml,200,200,scratches,1,7,199,69,100.0,38.0,198,62,3.193548387096774
validation,scratches_294.xml,200,200,scratches,2,80,128,120,65.0,100.0,126,40,3.15
validation,scratches_294.xml,200,200,scratches,1,108,194,123,97.5,115.5,193,15,12.866666666666667
validation,scratches_295.xml,200,200,scratches,1,10,199,49,100.0,29.5,198,39,5.076923076923077
validation,scratches_295.xml,200,200,scratches,45,55,108,84,76.5,69.5,63,29,2.1724137931034484
validation,scratches_295.xml,200,200,scratches,63,98,197,136,130.0,117.0,134,38,3.526315789473684
validation,scratches_295.xml,200,200,scratches,1,121,59,138,30.0,129.5,58,17,3.411764705882353
validation,scratches_296.xml,200,200,scratches,25,96,139,128,82.0,112.0,114,32,3.5625
validation,scratches_296.xml,200,200,scratches,112,141,200,156,156.0,148.5,88,15,5.866666666666666
validation,scratches_296.xml,200,200,scratches,1,141,76,153,38.5,147.0,75,12,6.25
validation,scratches_296.xml,200,200,scratches,150,26,200,51,175.0,38.5,50,25,2.0
validation,scratches_297.xml,200,200,scratches,132,122,199,138,165.5,130.0,67,16,4.1875
validation,scratches_297.xml,200,200,scratches,13,121,99,135,56.0,128.0,86,14,6.142857142857143
validation,scratches_298.xml,200,200,scratches,6,7,199,44,102.5,25.5,193,37,5.216216216216216
validation,scratches_299.xml,200,200,scratches,2,135,200,186,101.0,160.5,198,51,3.8823529411764706
validation,scratches_300.xml,200,200,scratches,88,1,200,34,144.0,17.5,112,33,3.393939393939394
validation,scratches_300.xml,200,200,scratches,2,16,86,34,44.0,25.0,84,18,4.666666666666667
