subset,file_name,width,height,class_name,xmin,ymin,xmax,ymax,xc,yc,w,h,aspect_ratio
train,crazing_1.xml,200,200,crazing,2,2,193,194,97.5,98.0,191,192,0.9947916666666666
train,crazing_10.xml,200,200,crazing,9,20,197,198,103.0,109.0,188,178,1.0561797752808988
train,crazing_100.xml,200,200,crazing,1,1,200,198,100.5,99.5,199,197,1.0101522842639594
train,crazing_101.xml,200,200,crazing,40,12,187,152,113.5,82.0,147,140,1.05
train,crazing_102.xml,200,200,crazing,2,2,144,153,73.0,77.5,142,151,0.9403973509933775
train,crazing_102.xml,200,200,crazing,150,85,199,178,174.5,131.5,49,93,0.5268817204301075
train,crazing_103.xml,200,200,crazing,1,18,198,191,99.5,104.5,197,173,1.138728323699422
train,crazing_104.xml,200,200,crazing,4,4,110,136,57.0,70.0,106,132,0.803030303030303
train,crazing_104.xml,200,200,crazing,137,10,199,116,168.0,63.0,62,106,0.5849056603773585
train,crazing_104.xml,200,200,patches,78,169,118,200,98.0,184.5,40,31,1.2903225806451613
train,crazing_105.xml,200,200,crazing,4,1,197,149,100.5,75.0,193,148,1.304054054054054
train,crazing_105.xml,200,200,inclusion,5,91,121,125,63.0,108.0,116,34,3.411764705882353
train,crazing_106.xml,200,200,crazing,1,24,189,188,95.0,106.0,188,164,1.146341463414634
train,crazing_107.xml,200,200,crazing,2,1,199,199,100.5,100.0,197,198,0.9949494949494949
train,crazing_108.xml,200,200,crazing,3,21,69,149,36.0,85.0,66,128,0.515625
train,crazing_108.xml,200,200,crazing,90,115,198,193,144.0,154.0,108,78,1.3846153846153846
train,crazing_109.xml,200,200,crazing,32,1,199,131,115.5,66.0,167,130,1.2846153846153847
train,crazing_11.xml,200,200,crazing,20,12,193,184,106.5,98.0,173,172,1.005813953488372
train,crazing_110.xml,200,200,crazing,1,16,89,79,45.0,47.5,88,63,1.3968253968253967
train,crazing_110.xml,200,200,crazing,105,18,193,75,149.0,46.5,88,57,1.543859649122807
train,crazing_111.xml,200,200,crazing,37,12,199,126,118.0,69.0,162,114,1.4210526315789473
train,crazing_112.xml,200,200,crazing,3,44,138,182,70.5,113.0,135,138,0.9782608695652174
train,crazing_112.xml,200,200,patches,124,34,165,112,144.5,73.0,41,78,0.5256410256410257
train,crazing_113.xml,200,200,crazing,1,48,162,186,81.5,117.0,161,138,1.1666666666666667
train,crazing_114.xml,200,200,crazing,2,16,169,198,85.5,107.0,167,182,0.9175824175824175
train,crazing_115.xml,200,200,crazing,9,25,192,141,100.5,83.0,183,116,1.5775862068965518
train,crazing_116.xml,200,200,crazing,19,13,174,186,96.5,99.5,155,173,0.8959537572254336
train,crazing_117.xml,200,200,crazing,12,39,169,189,90.5,114.0,157,150,1.0466666666666666
train,crazing_118.xml,200,200,crazing,1,65,195,188,98.0,126.5,194,123,1.5772357723577235
train,crazing_119.xml,200,200,crazing,1,14,193,157,97.0,85.5,192,143,1.3426573426573427
train,crazing_12.xml,200,200,crazing,1,1,141,162,71.0,81.5,140,161,0.8695652173913043
train,crazing_120.xml,200,200,crazing,1,6,200,152,100.5,79.0,199,146,1.3630136986301369
train,crazing_121.xml,200,200,crazing,23,21,173,171,98.0,96.0,150,150,1.0
train,crazing_122.xml,200,200,crazing,44,73,195,166,119.5,119.5,151,93,1.6236559139784945
train,crazing_123.xml,200,200,crazing,78,121,194,167,136.0,144.0,116,46,2.5217391304347827
train,crazing_124.xml,200,200,crazing,1,12,39,160,20.0,86.0,38,148,0.25675675675675674
train,crazing_124.xml,200,200,crazing,42,24,185,71,113.5,47.5,143,47,3.0425531914893615
train,crazing_125.xml,200,200,crazing,64,23,200,177,132.0,100.0,136,154,0.8831168831168831
train,crazing_126.xml,200,200,crazing,1,23,198,124,99.5,73.5,197,101,1.9504950495049505
train,crazing_127.xml,200,200,crazing,13,24,145,191,79.0,107.5,132,167,0.7904191616766467
train,crazing_128.xml,200,200,crazing,1,34,60,95,30.5,64.5,59,61,0.9672131147540983
train,crazing_128.xml,200,200,crazing,89,28,174,137,131.5,82.5,85,109,0.7798165137614679
train,crazing_129.xml,200,200,crazing,1,76,94,123,47.5,99.5,93,47,1.9787234042553192
train,crazing_129.xml,200,200,crazing,98,58,169,134,133.5,96.0,71,76,0.9342105263157895
train,crazing_13.xml,200,200,crazing,1,21,199,176,100.0,98.5,198,155,1.2774193548387096
train,crazing_130.xml,200,200,crazing,2,6,199,179,100.5,92.5,197,173,1.138728323699422
train,crazing_131.xml,200,200,crazing,1,17,194,186,97.5,101.5,193,169,1.1420118343195267
train,crazing_132.xml,200,200,crazing,37,29,152,149,94.5,89.0,115,120,0.9583333333333334
train,crazing_133.xml,200,200,crazing,47,94,169,194,108.0,144.0,122,100,1.22
train,crazing_134.xml,200,200,crazing,33,26,141,148,87.0,87.0,108,122,0.8852459016393442
train,crazing_135.xml,200,200,crazing,13,23,178,191,95.5,107.0,165,168,0.9821428571428571
train,crazing_136.xml,200,200,crazing,1,88,88,144,44.5,116.0,87,56,1.5535714285714286
train,crazing_136.xml,200,200,crazing,126,111,191,184,158.5,147.5,65,73,0.8904109589041096
train,crazing_137.xml,200,200,crazing,32,10,164,192,98.0,101.0,132,182,0.7252747252747253
train,crazing_138.xml,200,200,crazing,26,19,141,142,83.5,80.5,115,123,0.9349593495934959
train,crazing_139.xml,200,200,crazing,1,5,99,136,50.0,70.5,98,131,0.7480916030534351
train,crazing_14.xml,200,200,crazing,22,116,108,170,65.0,143.0,86,54,1.5925925925925926
train,crazing_140.xml,200,200,crazing,27,115,145,185,86.0,150.0,118,70,1.6857142857142857
train,crazing_140.xml,200,200,crazing,146,3,194,164,170.0,83.5,48,161,0.2981366459627329
train,crazing_141.xml,200,200,crazing,4,34,58,134,31.0,84.0,54,100,0.54
train,crazing_141.xml,200,200,crazing,73,117,198,157,135.5,137.0,125,40,3.125
train,crazing_142.xml,200,200,crazing,2,83,100,178,51.0,130.5,98,95,1.0315789473684212
train,crazing_142.xml,200,200,crazing,121,109,185,164,153.0,136.5,64,55,1.1636363636363636
train,crazing_143.xml,200,200,crazing,9,31,137,186,73.0,108.5,128,155,0.8258064516129032
train,crazing_144.xml,200,200,crazing,42,24,189,157,115.5,90.5,147,133,1.105263157894737
train,crazing_145.xml,200,200,crazing,20,9,164,176,92.0,92.5,144,167,0.8622754491017964
train,crazing_146.xml,200,200,crazing,43,109,95,193,69.0,151.0,52,84,0.6190476190476191
train,crazing_147.xml,200,200,crazing,3,42,72,93,37.5,67.5,69,51,1.3529411764705883
train,crazing_147.xml,200,200,crazing,90,117,164,159,127.0,138.0,74,42,1.7619047619047619
train,crazing_148.xml,200,200,crazing,4,39,85,97,44.5,68.0,81,58,1.396551724137931
train,crazing_149.xml,200,200,crazing,26,5,154,179,90.0,92.0,128,174,0.735632183908046
train,crazing_15.xml,200,200,crazing,27,16,167,101,97.0,58.5,140,85,1.6470588235294117
train,crazing_150.xml,200,200,crazing,52,148,186,196,119.0,172.0,134,48,2.7916666666666665
train,crazing_151.xml,200,200,crazing,91,21,134,106,112.5,63.5,43,85,0.5058823529411764
train,crazing_152.xml,200,200,crazing,2,98,146,191,74.0,144.5,144,93,1.5483870967741935
train,crazing_152.xml,200,200,patches,156,136,191,168,173.5,152.0,35,32,1.09375
train,crazing_153.xml,200,200,crazing,1,97,65,158,33.0,127.5,64,61,1.0491803278688525
train,crazing_153.xml,200,200,crazing,76,113,147,197,111.5,155.0,71,84,0.8452380952380952
train,crazing_154.xml,200,200,crazing,1,24,90,99,45.5,61.5,89,75,1.1866666666666668
train,crazing_154.xml,200,200,crazing,97,45,182,173,139.5,109.0,85,128,0.6640625
train,crazing_155.xml,200,200,crazing,2,9,108,149,55.0,79.0,106,140,0.7571428571428571
train,crazing_155.xml,200,200,crazing,111,55,191,168,151.0,111.5,80,113,0.7079646017699115
train,crazing_156.xml,200,200,crazing,1,24,193,156,97.0,90.0,192,132,1.4545454545454546
train,crazing_157.xml,200,200,crazing,48,3,166,157,107.0,80.0,118,154,0.7662337662337663
train,crazing_158.xml,200,200,crazing,51,57,125,135,88.0,96.0,74,78,0.9487179487179487
train,crazing_159.xml,200,200,crazing,35,4,197,183,116.0,93.5,162,179,0.9050279329608939
train,crazing_16.xml,200,200,crazing,11,102,75,157,43.0,129.5,64,55,1.1636363636363636
train,crazing_16.xml,200,200,crazing,105,124,178,175,141.5,149.5,73,51,1.4313725490196079
train,crazing_160.xml,200,200,crazing,13,20,154,190,83.5,105.0,141,170,0.8294117647058824
train,crazing_161.xml,200,200,crazing,77,9,152,138,114.5,73.5,75,129,0.5813953488372093
train,crazing_162.xml,200,200,crazing,58,12,130,149,94.0,80.5,72,137,0.5255474452554745
train,crazing_163.xml,200,200,crazing,1,86,69,185,35.0,135.5,68,99,0.6868686868686869
train,crazing_163.xml,200,200,crazing,72,28,191,198,131.5,113.0,119,170,0.7
train,crazing_164.xml,200,200,crazing,12,61,91,176,51.5,118.5,79,115,0.6869565217391305
train,crazing_165.xml,200,200,crazing,50,1,138,170,94.0,85.5,88,169,0.5207100591715976
train,crazing_166.xml,200,200,crazing,28,31,181,189,104.5,110.0,153,158,0.9683544303797469
train,crazing_167.xml,200,200,crazing,59,10,198,186,128.5,98.0,139,176,0.7897727272727273
train,crazing_168.xml,200,200,crazing,1,47,136,188,68.5,117.5,135,141,0.9574468085106383
train,crazing_169.xml,200,200,crazing,4,10,180,152,92.0,81.0,176,142,1.2394366197183098
train,crazing_17.xml,200,200,crazing,111,6,195,174,153.0,90.0,84,168,0.5
train,crazing_170.xml,200,200,crazing,23,11,135,180,79.0,95.5,112,169,0.6627218934911243
train,crazing_171.xml,200,200,crazing,96,9,192,89,144.0,49.0,96,80,1.2
train,crazing_172.xml,200,200,crazing,4,15,180,176,92.0,95.5,176,161,1.093167701863354
train,crazing_173.xml,200,200,crazing,32,27,198,198,115.0,112.5,166,171,0.9707602339181286
train,crazing_174.xml,200,200,crazing,1,82,174,181,87.5,131.5,173,99,1.7474747474747474
train,crazing_175.xml,200,200,crazing,1,92,151,194,76.0,143.0,150,102,1.4705882352941178
train,crazing_176.xml,200,200,crazing,20,50,195,188,107.5,119.0,175,138,1.2681159420289856
train,crazing_177.xml,200,200,crazing,6,42,183,199,94.5,120.5,177,157,1.127388535031847
train,crazing_178.xml,200,200,crazing,3,38,145,184,74.0,111.0,142,146,0.9726027397260274
train,crazing_179.xml,200,200,crazing,1,7,110,151,55.5,79.0,109,144,0.7569444444444444
train,crazing_18.xml,200,200,crazing,10,100,85,188,47.5,144.0,75,88,0.8522727272727273
train,crazing_18.xml,200,200,crazing,112,89,198,143,155.0,116.0,86,54,1.5925925925925926
train,crazing_180.xml,200,200,crazing,2,6,199,200,100.5,103.0,197,194,1.0154639175257731
train,crazing_181.xml,200,200,crazing,25,48,116,199,70.5,123.5,91,151,0.6026490066225165
train,crazing_182.xml,200,200,crazing,30,121,80,198,55.0,159.5,50,77,0.6493506493506493
train,crazing_182.xml,200,200,crazing,142,25,188,194,165.0,109.5,46,169,0.27218934911242604
train,crazing_183.xml,200,200,crazing,7,34,200,183,103.5,108.5,193,149,1.2953020134228188
train,crazing_184.xml,200,200,crazing,2,64,199,191,100.5,127.5,197,127,1.5511811023622046
train,crazing_185.xml,200,200,crazing,1,81,184,160,92.5,120.5,183,79,2.3164556962025316
train,crazing_186.xml,200,200,crazing,1,4,184,177,92.5,90.5,183,173,1.0578034682080926
train,crazing_187.xml,200,200,crazing,2,27,171,138,86.5,82.5,169,111,1.5225225225225225
train,crazing_188.xml,200,200,crazing,1,3,198,180,99.5,91.5,197,177,1.112994350282486
train,crazing_189.xml,200,200,crazing,3,16,177,152,90.0,84.0,174,136,1.2794117647058822
train,crazing_19.xml,200,200,crazing,92,5,135,116,113.5,60.5,43,111,0.38738738738738737
train,crazing_190.xml,200,200,crazing,1,1,182,157,91.5,79.0,181,156,1.1602564102564104
train,crazing_191.xml,200,200,crazing,8,22,198,195,103.0,108.5,190,173,1.0982658959537572
train,crazing_192.xml,200,200,crazing,17,18,199,198,108.0,108.0,182,180,1.011111111111111
train,crazing_193.xml,200,200,crazing,15,34,156,144,85.5,89.0,141,110,1.2818181818181817
train,crazing_194.xml,200,200,crazing,17,58,177,161,97.0,109.5,160,103,1.5533980582524272
train,crazing_195.xml,200,200,crazing,9,89,149,157,79.0,123.0,140,68,2.0588235294117645
train,crazing_196.xml,200,200,crazing,3,2,197,199,100.0,100.5,194,197,0.9847715736040609
train,crazing_197.xml,200,200,crazing,12,8,198,181,105.0,94.5,186,173,1.0751445086705202
train,crazing_198.xml,200,200,crazing,1,1,200,189,100.5,95.0,199,188,1.0585106382978724
train,crazing_199.xml,200,200,crazing,1,19,198,159,99.5,89.0,197,140,1.4071428571428573
train,crazing_2.xml,200,200,crazing,8,16,200,174,104.0,95.0,192,158,1.2151898734177216
train,crazing_20.xml,200,200,crazing,1,60,142,193,71.5,126.5,141,133,1.0601503759398496
train,crazing_20.xml,200,200,patches,140,29,178,65,159.0,47.0,38,36,1.0555555555555556
train,crazing_200.xml,200,200,crazing,4,7,176,196,90.0,101.5,172,189,0.91005291005291
train,crazing_201.xml,200,200,crazing,16,35,160,193,88.0,114.0,144,158,0.9113924050632911
train,crazing_202.xml,200,200,crazing,21,6,174,105,97.5,55.5,153,99,1.5454545454545454
train,crazing_203.xml,200,200,crazing,19,10,170,168,94.5,89.0,151,158,0.9556962025316456
train,crazing_204.xml,200,200,crazing,7,132,165,184,86.0,158.0,158,52,3.0384615384615383
train,crazing_205.xml,200,200,crazing,26,144,83,198,54.5,171.0,57,54,1.0555555555555556
train,crazing_206.xml,200,200,crazing,19,53,123,171,71.0,112.0,104,118,0.8813559322033898
train,crazing_206.xml,200,200,crazing,126,29,189,137,157.5,83.0,63,108,0.5833333333333334
train,crazing_207.xml,200,200,crazing,2,43,170,125,86.0,84.0,168,82,2.048780487804878
train,crazing_208.xml,200,200,crazing,1,20,198,194,99.5,107.0,197,174,1.132183908045977
train,crazing_209.xml,200,200,crazing,3,3,162,175,82.5,89.0,159,172,0.9244186046511628
train,crazing_21.xml,200,200,crazing,20,27,198,187,109.0,107.0,178,160,1.1125
train,crazing_210.xml,200,200,crazing,4,41,81,141,42.5,91.0,77,100,0.77
train,crazing_211.xml,200,200,crazing,1,1,185,184,93.0,92.5,184,183,1.005464480874317
train,crazing_212.xml,200,200,crazing,1,15,185,199,93.0,107.0,184,184,1.0
train,crazing_213.xml,200,200,crazing,26,7,157,198,91.5,102.5,131,191,0.6858638743455497
train,crazing_214.xml,200,200,crazing,9,1,200,192,104.5,96.5,191,191,1.0
train,crazing_215.xml,200,200,crazing,1,1,197,184,99.0,92.5,196,183,1.0710382513661203
train,crazing_216.xml,200,200,crazing,1,1,197,197,99.0,99.0,196,196,1.0
train,crazing_217.xml,200,200,crazing,25,52,199,190,112.0,121.0,174,138,1.2608695652173914
train,crazing_218.xml,200,200,crazing,18,16,198,181,108.0,98.5,180,165,1.0909090909090908
train,crazing_219.xml,200,200,crazing,46,9,116,123,81.0,66.0,70,114,0.6140350877192983
train,crazing_22.xml,200,200,crazing,92,17,200,182,146.0,99.5,108,165,0.6545454545454545
train,crazing_220.xml,200,200,crazing,3,19,178,194,90.5,106.5,175,175,1.0
train,crazing_221.xml,200,200,crazing,1,1,200,187,100.5,94.0,199,186,1.0698924731182795
train,crazing_222.xml,200,200,crazing,1,20,146,103,73.5,61.5,145,83,1.7469879518072289
train,crazing_222.xml,200,200,crazing,155,6,196,133,175.5,69.5,41,127,0.3228346456692913
train,crazing_223.xml,200,200,crazing,80,11,197,197,138.5,104.0,117,186,0.6290322580645161
train,crazing_224.xml,200,200,crazing,1,7,199,188,100.0,97.5,198,181,1.0939226519337018
train,crazing_225.xml,200,200,crazing,1,9,173,200,87.0,104.5,172,191,0.900523560209424
train,crazing_226.xml,200,200,crazing,1,19,174,196,87.5,107.5,173,177,0.9774011299435028
train,crazing_227.xml,200,200,crazing,12,1,200,159,106.0,80.0,188,158,1.1898734177215189
train,crazing_228.xml,200,200,crazing,3,22,199,192,101.0,107.0,196,170,1.1529411764705881
train,crazing_229.xml,200,200,crazing,1,6,187,198,94.0,102.0,186,192,0.96875
train,crazing_23.xml,200,200,crazing,1,6,180,200,90.5,103.0,179,194,0.9226804123711341
train,crazing_230.xml,200,200,crazing,1,28,181,182,91.0,105.0,180,154,1.1688311688311688
train,crazing_231.xml,200,200,crazing,1,8,200,187,100.5,97.5,199,179,1.111731843575419
train,crazing_232.xml,200,200,crazing,1,9,200,182,100.5,95.5,199,173,1.1502890173410405
train,crazing_233.xml,200,200,crazing,1,21,198,191,99.5,106.0,197,170,1.1588235294117648
train,crazing_234.xml,200,200,crazing,8,5,200,166,104.0,85.5,192,161,1.1925465838509317
train,crazing_235.xml,200,200,crazing,2,1,183,199,92.5,100.0,181,198,0.9141414141414141
train,crazing_236.xml,200,200,crazing,1,1,200,181,100.5,91.0,199,180,1.1055555555555556
train,crazing_237.xml,200,200,crazing,1,4,171,195,86.0,99.5,170,191,0.8900523560209425
train,crazing_238.xml,200,200,crazing,1,10,178,186,89.5,98.0,177,176,1.0056818181818181
train,crazing_239.xml,200,200,crazing,1,1,200,176,100.5,88.5,199,175,1.1371428571428572
train,crazing_24.xml,200,200,crazing,1,1,196,157,98.5,79.0,195,156,1.25
train,crazing_240.xml,200,200,crazing,12,2,200,200,106.0,101.0,188,198,0.9494949494949495
train,crazing_25.xml,200,200,crazing,1,1,159,144,80.0,72.5,158,143,1.1048951048951048
train,crazing_26.xml,200,200,crazing,25,1,199,174,112.0,87.5,174,173,1.0057803468208093
train,crazing_27.xml,200,200,crazing,6,18,199,190,102.5,104.0,193,172,1.122093023255814
train,crazing_28.xml,200,200,crazing,1,1,200,148,100.5,74.5,199,147,1.3537414965986394
train,crazing_29.xml,200,200,crazing,3,30,145,167,74.0,98.5,142,137,1.0364963503649636
train,crazing_3.xml,200,200,crazing,10,97,200,181,105.0,139.0,190,84,2.261904761904762
train,crazing_30.xml,200,200,crazing,1,10,200,174,100.5,92.0,199,164,1.2134146341463414
train,crazing_31.xml,200,200,crazing,3,3,200,197,101.5,100.0,197,194,1.0154639175257731
train,crazing_32.xml,200,200,crazing,1,2,158,163,79.5,82.5,157,161,0.9751552795031055
train,crazing_33.xml,200,200,crazing,35,1,132,85,83.5,43.0,97,84,1.1547619047619047
train,crazing_34.xml,200,200,crazing,2,1,200,200,101.0,100.5,198,199,0.9949748743718593
train,crazing_35.xml,200,200,crazing,1,1,200,169,100.5,85.0,199,168,1.1845238095238095
train,crazing_36.xml,200,200,crazing,74,93,200,171,137.0,132.0,126,78,1.6153846153846154
train,crazing_37.xml,200,200,crazing,74,51,200,154,137.0,102.5,126,103,1.2233009708737863
train,crazing_38.xml,200,200,crazing,66,1,200,199,133.0,100.0,134,198,0.6767676767676768
train,crazing_39.xml,200,200,crazing,5,3,200,191,102.5,97.0,195,188,1.0372340425531914
train,crazing_4.xml,200,200,crazing,10,3,197,198,103.5,100.5,187,195,0.958974358974359
train,crazing_40.xml,200,200,crazing,5,49,200,199,102.5,124.0,195,150,1.3
train,crazing_41.xml,200,200,crazing,10,1,197,198,103.5,99.5,187,197,0.949238578680203
train,crazing_42.xml,200,200,crazing,11,15,178,85,94.5,50.0,167,70,2.3857142857142857
train,crazing_43.xml,200,200,crazing,1,3,200,186,100.5,94.5,199,183,1.0874316939890711
train,crazing_44.xml,200,200,crazing,8,3,120,180,64.0,91.5,112,177,0.632768361581921
train,crazing_44.xml,200,200,crazing,146,19,199,177,172.5,98.0,53,158,0.33544303797468356
train,crazing_45.xml,200,200,crazing,2,54,119,172,60.5,113.0,117,118,0.9915254237288136
train,crazing_46.xml,200,200,crazing,11,33,100,103,55.5,68.0,89,70,1.2714285714285714
train,crazing_47.xml,200,200,crazing,1,1,105,199,53.0,100.0,104,198,0.5252525252525253
train,crazing_48.xml,200,200,crazing,5,5,195,183,100.0,94.0,190,178,1.0674157303370786
train,crazing_49.xml,200,200,crazing,1,42,200,199,100.5,120.5,199,157,1.267515923566879
train,crazing_5.xml,200,200,crazing,1,4,199,176,100.0,90.0,198,172,1.1511627906976745
train,crazing_50.xml,200,200,crazing,2,52,200,199,101.0,125.5,198,147,1.346938775510204
train,crazing_51.xml,200,200,crazing,53,1,200,160,126.5,80.5,147,159,0.9245283018867925
train,crazing_52.xml,200,200,crazing,56,3,200,194,128.0,98.5,144,191,0.7539267015706806
train,crazing_53.xml,200,200,crazing,1,33,123,198,62.0,115.5,122,165,0.7393939393939394
train,crazing_54.xml,200,200,crazing,28,26,196,157,112.0,91.5,168,131,1.282442748091603
train,crazing_55.xml,200,200,crazing,4,9,192,166,98.0,87.5,188,157,1.197452229299363
train,crazing_56.xml,200,200,crazing,1,7,199,156,100.0,81.5,198,149,1.3288590604026846
train,crazing_57.xml,200,200,crazing,1,35,114,111,57.5,73.0,113,76,1.486842105263158
train,crazing_57.xml,200,200,crazing,133,1,200,146,166.5,73.5,67,145,0.46206896551724136
train,crazing_58.xml,200,200,crazing,1,34,196,198,98.5,116.0,195,164,1.1890243902439024
train,crazing_59.xml,200,200,crazing,67,72,200,136,133.5,104.0,133,64,2.078125
train,crazing_6.xml,200,200,crazing,11,3,196,199,103.5,101.0,185,196,0.9438775510204082
train,crazing_60.xml,200,200,crazing,30,43,200,199,115.0,121.0,170,156,1.0897435897435896
train,crazing_61.xml,200,200,crazing,28,30,198,166,113.0,98.0,170,136,1.25
train,crazing_62.xml,200,200,crazing,1,13,89,83,45.0,48.0,88,70,1.2571428571428571
train,crazing_62.xml,200,200,crazing,142,128,200,174,171.0,151.0,58,46,1.2608695652173914
train,crazing_63.xml,200,200,crazing,35,17,200,197,117.5,107.0,165,180,0.9166666666666666
train,crazing_64.xml,200,200,crazing,3,19,200,194,101.5,106.5,197,175,1.1257142857142857
train,crazing_65.xml,200,200,crazing,3,2,103,199,53.0,100.5,100,197,0.5076142131979695
train,crazing_65.xml,200,200,crazing,124,3,199,162,161.5,82.5,75,159,0.4716981132075472
train,crazing_66.xml,200,200,crazing,27,13,149,164,88.0,88.5,122,151,0.8079470198675497
train,crazing_67.xml,200,200,crazing,7,40,157,145,82.0,92.5,150,105,1.4285714285714286
train,crazing_68.xml,200,200,crazing,36,48,196,194,116.0,121.0,160,146,1.095890410958904
train,crazing_69.xml,200,200,crazing,1,20,189,187,95.0,103.5,188,167,1.125748502994012
train,crazing_7.xml,200,200,crazing,1,2,200,163,100.5,82.5,199,161,1.236024844720497
train,crazing_70.xml,200,200,crazing,33,2,174,200,103.5,101.0,141,198,0.7121212121212122
train,crazing_71.xml,200,200,crazing,1,2,199,200,100.0,101.0,198,198,1.0
train,crazing_72.xml,200,200,crazing,6,48,200,197,103.0,122.5,194,149,1.3020134228187918
train,crazing_73.xml,200,200,crazing,26,41,165,189,95.5,115.0,139,148,0.9391891891891891
train,crazing_74.xml,200,200,crazing,2,43,105,158,53.5,100.5,103,115,0.8956521739130435
train,crazing_74.xml,200,200,crazing,130,52,190,167,160.0,109.5,60,115,0.5217391304347826
train,crazing_75.xml,200,200,crazing,4,54,147,161,75.5,107.5,143,107,1.3364485981308412
train,crazing_75.xml,200,200,crazing,158,24,200,173,179.0,98.5,42,149,0.28187919463087246
train,crazing_76.xml,200,200,crazing,1,19,198,189,99.5,104.0,197,170,1.1588235294117648
train,crazing_77.xml,200,200,crazing,25,27,183,163,104.0,95.0,158,136,1.161764705882353
train,crazing_78.xml,200,200,crazing,1,1,198,130,99.5,65.5,197,129,1.5271317829457365
train,crazing_79.xml,200,200,crazing,7,88,113,175,60.0,131.5,106,87,1.2183908045977012
train,crazing_79.xml,200,200,crazing,132,55,200,133,166.0,94.0,68,78,0.8717948717948718
train,crazing_8.xml,200,200,crazing,1,26,179,200,90.0,113.0,178,174,1.0229885057471264
train,crazing_80.xml,200,200,crazing,112,69,198,150,155.0,109.5,86,81,1.0617283950617284
train,crazing_81.xml,200,200,crazing,2,84,177,182,89.5,133.0,175,98,1.7857142857142858
train,crazing_82.xml,200,200,crazing,4,83,107,198,55.5,140.5,103,115,0.8956521739130435
train,crazing_82.xml,200,200,crazing,122,41,200,199,161.0,120.0,78,158,0.4936708860759494
train,crazing_83.xml,200,200,crazing,1,1,197,198,99.0,99.5,196,197,0.9949238578680203
train,crazing_84.xml,200,200,crazing,31,90,182,198,106.5,144.0,151,108,1.3981481481481481
train,crazing_85.xml,200,200,crazing,9,5,200,200,104.5,102.5,191,195,0.9794871794871794
train,crazing_86.xml,200,200,crazing,1,4,200,174,100.5,89.0,199,170,1.1705882352941177
train,crazing_87.xml,200,200,crazing,18,9,200,196,109.0,102.5,182,187,0.9732620320855615
train,crazing_88.xml,200,200,crazing,18,34,200,172,109.0,103.0,182,138,1.318840579710145
train,crazing_89.xml,200,200,crazing,3,20,192,187,97.5,103.5,189,167,1.1317365269461077
train,crazing_9.xml,200,200,crazing,1,24,121,74,61.0,49.0,120,50,2.4
train,crazing_9.xml,200,200,crazing,130,1,200,83,165.0,42.0,70,82,0.8536585365853658
train,crazing_90.xml,200,200,crazing,58,5,155,105,106.5,55.0,97,100,0.97
train,crazing_91.xml,200,200,crazing,10,10,198,182,104.0,96.0,188,172,1.0930232558139534
train,crazing_92.xml,200,200,crazing,8,38,191,197,99.5,117.5,183,159,1.150943396226415
train,crazing_93.xml,200,200,crazing,2,24,168,198,85.0,111.0,166,174,0.9540229885057471
train,crazing_94.xml,200,200,crazing,1,34,200,167,100.5,100.5,199,133,1.4962406015037595
train,crazing_95.xml,200,200,crazing,1,11,200,181,100.5,96.0,199,170,1.1705882352941177
train,crazing_96.xml,200,200,crazing,1,9,198,200,99.5,104.5,197,191,1.031413612565445
train,crazing_97.xml,200,200,crazing,3,3,200,188,101.5,95.5,197,185,1.0648648648648649
train,crazing_98.xml,200,200,crazing,1,3,198,194,99.5,98.5,197,191,1.031413612565445
train,crazing_99.xml,200,200,crazing,3,2,105,200,54.0,101.0,102,198,0.5151515151515151
train,crazing_99.xml,200,200,crazing,126,49,200,198,163.0,123.5,74,149,0.4966442953020134
train,inclusion_1.xml,200,200,inclusion,33,5,46,36,39.5,20.5,13,31,0.41935483870967744
train,inclusion_1.xml,200,200,inclusion,115,34,140,116,127.5,75.0,25,82,0.3048780487804878
train,inclusion_1.xml,200,200,inclusion,116,115,135,198,125.5,156.5,19,83,0.2289156626506024
train,inclusion_10.xml,200,200,inclusion,58,1,81,131,69.5,66.0,23,130,0.17692307692307693
train,inclusion_10.xml,200,200,inclusion,149,129,163,158,156.0,143.5,14,29,0.4827586206896552
train,inclusion_100.xml,200,200,inclusion,64,1,126,197,95.0,99.0,62,196,0.3163265306122449
train,inclusion_101.xml,200,200,inclusion,110,1,165,198,137.5,99.5,55,197,0.27918781725888325
train,inclusion_102.xml,200,200,inclusion,28,1,73,198,50.5,99.5,45,197,0.22842639593908629
train,inclusion_102.xml,200,200,inclusion,132,70,147,130,139.5,100.0,15,60,0.25
train,inclusion_103.xml,200,200,inclusion,128,1,179,198,153.5,99.5,51,197,0.25888324873096447
train,inclusion_104.xml,200,200,inclusion,15,1,73,198,44.0,99.5,58,197,0.29441624365482233
train,inclusion_104.xml,200,200,inclusion,117,106,134,163,125.5,134.5,17,57,0.2982456140350877
train,inclusion_105.xml,200,200,inclusion,52,1,126,198,89.0,99.5,74,197,0.3756345177664975
train,inclusion_105.xml,200,200,inclusion,144,55,162,106,153.0,80.5,18,51,0.35294117647058826
train,inclusion_106.xml,200,200,inclusion,75,10,126,198,100.5,104.0,51,188,0.2712765957446808
train,inclusion_107.xml,200,200,inclusion,35,17,56,164,45.5,90.5,21,147,0.14285714285714285
train,inclusion_107.xml,200,200,inclusion,64,106,85,127,74.5,116.5,21,21,1.0
train,inclusion_107.xml,200,200,inclusion,100,125,116,168,108.0,146.5,16,43,0.37209302325581395
train,inclusion_108.xml,200,200,inclusion,96,45,124,142,110.0,93.5,28,97,0.28865979381443296
train,inclusion_108.xml,200,200,inclusion,143,1,177,198,160.0,99.5,34,197,0.17258883248730963
train,inclusion_109.xml,200,200,inclusion,1,35,28,145,14.5,90.0,27,110,0.24545454545454545
train,inclusion_109.xml,200,200,inclusion,39,1,74,198,56.5,99.5,35,197,0.17766497461928935
train,inclusion_109.xml,200,200,inclusion,132,1,167,187,149.5,94.0,35,186,0.1881720430107527
train,inclusion_11.xml,200,200,inclusion,30,23,78,198,54.0,110.5,48,175,0.2742857142857143
train,inclusion_110.xml,200,200,inclusion,95,1,138,198,116.5,99.5,43,197,0.2182741116751269
train,inclusion_110.xml,200,200,inclusion,144,1,178,198,161.0,99.5,34,197,0.17258883248730963
train,inclusion_111.xml,200,200,inclusion,3,1,63,198,33.0,99.5,60,197,0.30456852791878175
train,inclusion_111.xml,200,200,inclusion,92,150,120,198,106.0,174.0,28,48,0.5833333333333334
train,inclusion_111.xml,200,200,inclusion,123,1,153,198,138.0,99.5,30,197,0.15228426395939088
train,inclusion_112.xml,200,200,inclusion,56,1,87,138,71.5,69.5,31,137,0.22627737226277372
train,inclusion_112.xml,200,200,inclusion,94,1,111,49,102.5,25.0,17,48,0.3541666666666667
train,inclusion_112.xml,200,200,inclusion,182,8,198,62,190.0,35.0,16,54,0.2962962962962963
train,inclusion_113.xml,200,200,inclusion,6,3,49,198,27.5,100.5,43,195,0.2205128205128205
train,inclusion_113.xml,200,200,inclusion,75,120,105,199,90.0,159.5,30,79,0.379746835443038
train,inclusion_113.xml,200,200,inclusion,109,1,142,198,125.5,99.5,33,197,0.16751269035532995
train,inclusion_113.xml,200,200,inclusion,167,160,188,198,177.5,179.0,21,38,0.5526315789473685
train,inclusion_114.xml,200,200,inclusion,1,1,29,132,15.0,66.5,28,131,0.21374045801526717
train,inclusion_114.xml,200,200,inclusion,49,77,80,198,64.5,137.5,31,121,0.256198347107438
train,inclusion_114.xml,200,200,inclusion,85,1,107,120,96.0,60.5,22,119,0.18487394957983194
train,inclusion_114.xml,200,200,inclusion,90,114,117,180,103.5,147.0,27,66,0.4090909090909091
train,inclusion_114.xml,200,200,inclusion,139,115,160,192,149.5,153.5,21,77,0.2727272727272727
train,inclusion_115.xml,200,200,inclusion,16,59,37,113,26.5,86.0,21,54,0.3888888888888889
train,inclusion_115.xml,200,200,inclusion,41,1,82,195,61.5,98.0,41,194,0.211340206185567
train,inclusion_115.xml,200,200,inclusion,105,74,138,198,121.5,136.0,33,124,0.2661290322580645
train,inclusion_115.xml,200,200,inclusion,144,1,172,181,158.0,91.0,28,180,0.15555555555555556
train,inclusion_116.xml,200,200,inclusion,71,29,92,86,81.5,57.5,21,57,0.3684210526315789
train,inclusion_116.xml,200,200,inclusion,98,1,135,199,116.5,100.0,37,198,0.18686868686868688
train,inclusion_116.xml,200,200,inclusion,159,47,191,199,175.0,123.0,32,152,0.21052631578947367
train,inclusion_117.xml,200,200,inclusion,21,1,91,189,56.0,95.0,70,188,0.3723404255319149
train,inclusion_117.xml,200,200,inclusion,116,26,133,101,124.5,63.5,17,75,0.22666666666666666
train,inclusion_118.xml,200,200,inclusion,115,2,139,53,127.0,27.5,24,51,0.47058823529411764
train,inclusion_118.xml,200,200,inclusion,144,1,182,199,163.0,100.0,38,198,0.1919191919191919
train,inclusion_119.xml,200,200,inclusion,74,1,93,46,83.5,23.5,19,45,0.4222222222222222
train,inclusion_119.xml,200,200,inclusion,98,1,136,198,117.0,99.5,38,197,0.19289340101522842
train,inclusion_119.xml,200,200,inclusion,160,16,194,175,177.0,95.5,34,159,0.2138364779874214
train,inclusion_12.xml,200,200,inclusion,18,4,62,198,40.0,101.0,44,194,0.2268041237113402
train,inclusion_12.xml,200,200,inclusion,75,38,111,182,93.0,110.0,36,144,0.25
train,inclusion_12.xml,200,200,inclusion,114,100,127,130,120.5,115.0,13,30,0.43333333333333335
train,inclusion_12.xml,200,200,inclusion,138,1,186,198,162.0,99.5,48,197,0.2436548223350254
train,inclusion_120.xml,200,200,inclusion,22,1,60,198,41.0,99.5,38,197,0.19289340101522842
train,inclusion_120.xml,200,200,inclusion,82,1,107,59,94.5,30.0,25,58,0.43103448275862066
train,inclusion_120.xml,200,200,inclusion,115,62,144,200,129.5,131.0,29,138,0.21014492753623187
train,inclusion_120.xml,200,200,inclusion,150,128,166,177,158.0,152.5,16,49,0.32653061224489793
train,inclusion_121.xml,200,200,inclusion,78,5,119,198,98.5,101.5,41,193,0.21243523316062177
train,inclusion_121.xml,200,200,inclusion,107,16,159,198,133.0,107.0,52,182,0.2857142857142857
train,inclusion_122.xml,200,200,inclusion,18,1,71,198,44.5,99.5,53,197,0.26903553299492383
train,inclusion_122.xml,200,200,inclusion,110,1,158,199,134.0,100.0,48,198,0.24242424242424243
train,inclusion_122.xml,200,200,inclusion,166,1,179,26,172.5,13.5,13,25,0.52
train,inclusion_123.xml,200,200,inclusion,45,1,96,198,70.5,99.5,51,197,0.25888324873096447
train,inclusion_124.xml,200,200,inclusion,13,18,39,151,26.0,84.5,26,133,0.19548872180451127
train,inclusion_124.xml,200,200,inclusion,39,1,71,197,55.0,99.0,32,196,0.16326530612244897
train,inclusion_124.xml,200,200,inclusion,113,1,145,87,129.0,44.0,32,86,0.37209302325581395
train,inclusion_125.xml,200,200,inclusion,33,62,47,173,40.0,117.5,14,111,0.12612612612612611
train,inclusion_125.xml,200,200,inclusion,57,31,73,75,65.0,53.0,16,44,0.36363636363636365
train,inclusion_125.xml,200,200,inclusion,88,1,127,187,107.5,94.0,39,186,0.20967741935483872
train,inclusion_125.xml,200,200,inclusion,130,31,167,142,148.5,86.5,37,111,0.3333333333333333
train,inclusion_126.xml,200,200,inclusion,2,1,43,160,22.5,80.5,41,159,0.2578616352201258
train,inclusion_126.xml,200,200,inclusion,50,1,85,102,67.5,51.5,35,101,0.3465346534653465
train,inclusion_126.xml,200,200,inclusion,94,175,106,198,100.0,186.5,12,23,0.5217391304347826
train,inclusion_127.xml,200,200,inclusion,34,40,48,76,41.0,58.0,14,36,0.3888888888888889
train,inclusion_127.xml,200,200,inclusion,68,85,120,199,94.0,142.0,52,114,0.45614035087719296
train,inclusion_128.xml,200,200,inclusion,31,1,42,25,36.5,13.0,11,24,0.4583333333333333
train,inclusion_128.xml,200,200,inclusion,68,40,117,173,92.5,106.5,49,133,0.3684210526315789
train,inclusion_129.xml,200,200,inclusion,23,143,41,199,32.0,171.0,18,56,0.32142857142857145
train,inclusion_129.xml,200,200,inclusion,44,1,99,128,71.5,64.5,55,127,0.4330708661417323
train,inclusion_129.xml,200,200,inclusion,163,108,190,160,176.5,134.0,27,52,0.5192307692307693
train,inclusion_13.xml,200,200,inclusion,60,1,98,198,79.0,99.5,38,197,0.19289340101522842
train,inclusion_13.xml,200,200,inclusion,106,2,153,200,129.5,101.0,47,198,0.23737373737373738
train,inclusion_13.xml,200,200,inclusion,160,36,194,187,177.0,111.5,34,151,0.2251655629139073
train,inclusion_130.xml,200,200,inclusion,15,7,42,70,28.5,38.5,27,63,0.42857142857142855
train,inclusion_130.xml,200,200,inclusion,87,4,115,191,101.0,97.5,28,187,0.1497326203208556
train,inclusion_130.xml,200,200,inclusion,112,132,128,175,120.0,153.5,16,43,0.37209302325581395
train,inclusion_130.xml,200,200,inclusion,138,95,155,126,146.5,110.5,17,31,0.5483870967741935
train,inclusion_130.xml,200,200,inclusion,161,39,198,192,179.5,115.5,37,153,0.24183006535947713
train,inclusion_131.xml,200,200,inclusion,39,1,92,197,65.5,99.0,53,196,0.27040816326530615
train,inclusion_132.xml,200,200,inclusion,69,2,115,197,92.0,99.5,46,195,0.2358974358974359
train,inclusion_133.xml,200,200,inclusion,69,1,140,200,104.5,100.5,71,199,0.35678391959798994
train,inclusion_134.xml,200,200,inclusion,53,1,99,199,76.0,100.0,46,198,0.23232323232323232
train,inclusion_135.xml,200,200,inclusion,41,1,98,198,69.5,99.5,57,197,0.2893401015228426
train,inclusion_136.xml,200,200,inclusion,166,70,188,117,177.0,93.5,22,47,0.46808510638297873
train,inclusion_137.xml,200,200,inclusion,50,1,74,47,62.0,24.0,24,46,0.5217391304347826
train,inclusion_137.xml,200,200,inclusion,96,120,110,145,103.0,132.5,14,25,0.56
train,inclusion_138.xml,200,200,inclusion,138,125,162,180,150.0,152.5,24,55,0.43636363636363634
train,inclusion_138.xml,200,200,inclusion,173,17,187,39,180.0,28.0,14,22,0.6363636363636364
train,inclusion_139.xml,200,200,inclusion,58,72,92,186,75.0,129.0,34,114,0.2982456140350877
train,inclusion_139.xml,200,200,inclusion,164,103,179,126,171.5,114.5,15,23,0.6521739130434783
train,inclusion_14.xml,200,200,inclusion,2,9,42,188,22.0,98.5,40,179,0.22346368715083798
train,inclusion_14.xml,200,200,inclusion,91,150,115,194,103.0,172.0,24,44,0.5454545454545454
train,inclusion_140.xml,200,200,inclusion,106,6,140,118,123.0,62.0,34,112,0.30357142857142855
train,inclusion_141.xml,200,200,inclusion,99,3,127,183,113.0,93.0,28,180,0.15555555555555556
train,inclusion_142.xml,200,200,inclusion,56,34,70,56,63.0,45.0,14,22,0.6363636363636364
train,inclusion_142.xml,200,200,inclusion,142,130,159,170,150.5,150.0,17,40,0.425
train,inclusion_143.xml,200,200,inclusion,29,15,59,151,44.0,83.0,30,136,0.22058823529411764
train,inclusion_144.xml,200,200,inclusion,113,13,142,123,127.5,68.0,29,110,0.2636363636363636
train,inclusion_144.xml,200,200,inclusion,116,122,130,151,123.0,136.5,14,29,0.4827586206896552
train,inclusion_145.xml,200,200,inclusion,53,43,102,198,77.5,120.5,49,155,0.3161290322580645
train,inclusion_146.xml,200,200,inclusion,20,132,40,174,30.0,153.0,20,42,0.47619047619047616
train,inclusion_146.xml,200,200,inclusion,87,4,140,194,113.5,99.0,53,190,0.2789473684210526
train,inclusion_147.xml,200,200,inclusion,74,115,96,161,85.0,138.0,22,46,0.4782608695652174
train,inclusion_147.xml,200,200,inclusion,141,1,194,184,167.5,92.5,53,183,0.2896174863387978
train,inclusion_148.xml,200,200,inclusion,15,1,62,133,38.5,67.0,47,132,0.3560606060606061
train,inclusion_149.xml,200,200,inclusion,55,1,77,62,66.0,31.5,22,61,0.36065573770491804
train,inclusion_149.xml,200,200,inclusion,79,119,99,158,89.0,138.5,20,39,0.5128205128205128
train,inclusion_15.xml,200,200,inclusion,47,1,73,199,60.0,100.0,26,198,0.13131313131313133
train,inclusion_15.xml,200,200,inclusion,93,10,124,200,108.5,105.0,31,190,0.1631578947368421
train,inclusion_15.xml,200,200,inclusion,147,1,179,124,163.0,62.5,32,123,0.2601626016260163
train,inclusion_15.xml,200,200,inclusion,182,43,197,74,189.5,58.5,15,31,0.4838709677419355
train,inclusion_150.xml,200,200,inclusion,135,43,180,196,157.5,119.5,45,153,0.29411764705882354
train,inclusion_151.xml,200,200,inclusion,11,13,62,171,36.5,92.0,51,158,0.3227848101265823
train,inclusion_151.xml,200,200,inclusion,76,62,171,200,123.5,131.0,95,138,0.6884057971014492
train,inclusion_152.xml,200,200,inclusion,18,10,108,198,63.0,104.0,90,188,0.4787234042553192
train,inclusion_153.xml,200,200,inclusion,22,1,100,198,61.0,99.5,78,197,0.39593908629441626
train,inclusion_153.xml,200,200,inclusion,102,1,118,48,110.0,24.5,16,47,0.3404255319148936
train,inclusion_154.xml,200,200,inclusion,51,54,89,177,70.0,115.5,38,123,0.3089430894308943
train,inclusion_154.xml,200,200,inclusion,92,10,126,195,109.0,102.5,34,185,0.1837837837837838
train,inclusion_154.xml,200,200,inclusion,156,1,198,163,177.0,82.0,42,162,0.25925925925925924
train,inclusion_155.xml,200,200,inclusion,86,8,118,78,102.0,43.0,32,70,0.45714285714285713
train,inclusion_155.xml,200,200,inclusion,125,10,154,122,139.5,66.0,29,112,0.25892857142857145
train,inclusion_155.xml,200,200,inclusion,132,113,167,198,149.5,155.5,35,85,0.4117647058823529
train,inclusion_156.xml,200,200,inclusion,11,1,48,148,29.5,74.5,37,147,0.25170068027210885
train,inclusion_156.xml,200,200,inclusion,87,1,106,66,96.5,33.5,19,65,0.2923076923076923
train,inclusion_156.xml,200,200,inclusion,106,2,142,196,124.0,99.0,36,194,0.18556701030927836
train,inclusion_157.xml,200,200,inclusion,17,79,40,169,28.5,124.0,23,90,0.25555555555555554
train,inclusion_157.xml,200,200,inclusion,70,15,144,197,107.0,106.0,74,182,0.4065934065934066
train,inclusion_157.xml,200,200,inclusion,171,1,199,189,185.0,95.0,28,188,0.14893617021276595
train,inclusion_158.xml,200,200,inclusion,79,46,101,136,90.0,91.0,22,90,0.24444444444444444
train,inclusion_158.xml,200,200,inclusion,130,78,198,198,164.0,138.0,68,120,0.5666666666666667
train,inclusion_159.xml,200,200,inclusion,42,52,64,170,53.0,111.0,22,118,0.1864406779661017
train,inclusion_159.xml,200,200,inclusion,67,1,98,198,82.5,99.5,31,197,0.15736040609137056
train,inclusion_16.xml,200,200,inclusion,119,1,146,194,132.5,97.5,27,193,0.13989637305699482
train,inclusion_16.xml,200,200,inclusion,168,1,194,120,181.0,60.5,26,119,0.2184873949579832
train,inclusion_16.xml,200,200,inclusion,173,116,198,198,185.5,157.0,25,82,0.3048780487804878
train,inclusion_160.xml,200,200,inclusion,65,25,90,198,77.5,111.5,25,173,0.14450867052023122
train,inclusion_160.xml,200,200,inclusion,90,25,128,198,109.0,111.5,38,173,0.21965317919075145
train,inclusion_161.xml,200,200,inclusion,47,1,128,199,87.5,100.0,81,198,0.4090909090909091
train,inclusion_162.xml,200,200,inclusion,21,23,73,170,47.0,96.5,52,147,0.35374149659863946
train,inclusion_162.xml,200,200,inclusion,85,69,138,198,111.5,133.5,53,129,0.4108527131782946
train,inclusion_162.xml,200,200,inclusion,135,86,182,197,158.5,141.5,47,111,0.42342342342342343
train,inclusion_163.xml,200,200,inclusion,1,22,33,170,17.0,96.0,32,148,0.21621621621621623
train,inclusion_163.xml,200,200,inclusion,47,70,141,200,94.0,135.0,94,130,0.7230769230769231
train,inclusion_164.xml,200,200,inclusion,33,1,111,198,72.0,99.5,78,197,0.39593908629441626
train,inclusion_164.xml,200,200,inclusion,136,1,198,198,167.0,99.5,62,197,0.3147208121827411
train,inclusion_165.xml,200,200,inclusion,1,18,25,166,13.0,92.0,24,148,0.16216216216216217
train,inclusion_165.xml,200,200,inclusion,7,155,28,200,17.5,177.5,21,45,0.4666666666666667
train,inclusion_165.xml,200,200,inclusion,67,1,142,197,104.5,99.0,75,196,0.3826530612244898
train,inclusion_166.xml,200,200,inclusion,53,4,86,73,69.5,38.5,33,69,0.4782608695652174
train,inclusion_166.xml,200,200,inclusion,93,6,130,197,111.5,101.5,37,191,0.193717277486911
train,inclusion_166.xml,200,200,inclusion,161,1,199,187,180.0,94.0,38,186,0.20430107526881722
train,inclusion_167.xml,200,200,inclusion,10,6,53,189,31.5,97.5,43,183,0.23497267759562843
train,inclusion_167.xml,200,200,inclusion,92,10,114,86,103.0,48.0,22,76,0.2894736842105263
train,inclusion_167.xml,200,200,inclusion,110,1,144,200,127.0,100.5,34,199,0.1708542713567839
train,inclusion_168.xml,200,200,inclusion,1,1,64,199,32.5,100.0,63,198,0.3181818181818182
train,inclusion_169.xml,200,200,inclusion,75,156,99,190,87.0,173.0,24,34,0.7058823529411765
train,inclusion_169.xml,200,200,inclusion,102,1,136,198,119.0,99.5,34,197,0.17258883248730963
train,inclusion_17.xml,200,200,inclusion,16,25,42,198,29.0,111.5,26,173,0.15028901734104047
train,inclusion_17.xml,200,200,inclusion,46,124,61,159,53.5,141.5,15,35,0.42857142857142855
train,inclusion_17.xml,200,200,inclusion,70,42,86,74,78.0,58.0,16,32,0.5
train,inclusion_17.xml,200,200,inclusion,116,88,150,200,133.0,144.0,34,112,0.30357142857142855
train,inclusion_170.xml,200,200,inclusion,77,16,129,199,103.0,107.5,52,183,0.28415300546448086
train,inclusion_171.xml,200,200,inclusion,81,1,123,198,102.0,99.5,42,197,0.2131979695431472
train,inclusion_172.xml,200,200,inclusion,77,13,106,195,91.5,104.0,29,182,0.15934065934065933
train,inclusion_173.xml,200,200,inclusion,155,1,184,180,169.5,90.5,29,179,0.16201117318435754
train,inclusion_174.xml,200,200,inclusion,64,1,89,107,76.5,54.0,25,106,0.2358490566037736
train,inclusion_175.xml,200,200,inclusion,92,74,140,199,116.0,136.5,48,125,0.384
train,inclusion_176.xml,200,200,inclusion,2,139,23,178,12.5,158.5,21,39,0.5384615384615384
train,inclusion_176.xml,200,200,inclusion,65,1,117,197,91.0,99.0,52,196,0.2653061224489796
train,inclusion_177.xml,200,200,inclusion,28,34,56,155,42.0,94.5,28,121,0.23140495867768596
train,inclusion_177.xml,200,200,inclusion,92,38,108,76,100.0,57.0,16,38,0.42105263157894735
train,inclusion_177.xml,200,200,inclusion,146,12,180,199,163.0,105.5,34,187,0.18181818181818182
train,inclusion_178.xml,200,200,inclusion,10,17,38,182,24.0,99.5,28,165,0.1696969696969697
train,inclusion_178.xml,200,200,inclusion,113,130,135,168,124.0,149.0,22,38,0.5789473684210527
train,inclusion_178.xml,200,200,inclusion,176,6,199,110,187.5,58.0,23,104,0.22115384615384615
train,inclusion_179.xml,200,200,inclusion,21,130,64,197,42.5,163.5,43,67,0.6417910447761194
train,inclusion_179.xml,200,200,inclusion,136,11,155,53,145.5,32.0,19,42,0.4523809523809524
train,inclusion_18.xml,200,200,inclusion,8,1,32,161,20.0,81.0,24,160,0.15
train,inclusion_18.xml,200,200,inclusion,28,138,51,186,39.5,162.0,23,48,0.4791666666666667
train,inclusion_18.xml,200,200,inclusion,68,50,90,199,79.0,124.5,22,149,0.1476510067114094
train,inclusion_18.xml,200,200,inclusion,117,1,143,137,130.0,69.0,26,136,0.19117647058823528
train,inclusion_18.xml,200,200,inclusion,148,16,181,198,164.5,107.0,33,182,0.1813186813186813
train,inclusion_180.xml,200,200,inclusion,81,19,111,163,96.0,91.0,30,144,0.20833333333333334
train,inclusion_180.xml,200,200,inclusion,140,51,156,86,148.0,68.5,16,35,0.45714285714285713
train,inclusion_181.xml,200,200,inclusion,27,54,54,183,40.5,118.5,27,129,0.20930232558139536
train,inclusion_181.xml,200,200,inclusion,56,1,83,198,69.5,99.5,27,197,0.13705583756345177
train,inclusion_181.xml,200,200,inclusion,118,11,145,199,131.5,105.0,27,188,0.14361702127659576
train,inclusion_182.xml,200,200,inclusion,136,1,165,199,150.5,100.0,29,198,0.14646464646464646
train,inclusion_182.xml,200,200,inclusion,162,1,184,198,173.0,99.5,22,197,0.1116751269035533
train,inclusion_183.xml,200,200,inclusion,124,1,180,197,152.0,99.0,56,196,0.2857142857142857
train,inclusion_184.xml,200,200,inclusion,54,1,107,197,80.5,99.0,53,196,0.27040816326530615
train,inclusion_185.xml,200,200,inclusion,27,1,79,183,53.0,92.0,52,182,0.2857142857142857
train,inclusion_186.xml,200,200,inclusion,67,1,117,199,92.0,100.0,50,198,0.25252525252525254
train,inclusion_187.xml,200,200,inclusion,25,56,63,195,44.0,125.5,38,139,0.2733812949640288
train,inclusion_188.xml,200,200,inclusion,90,32,129,171,109.5,101.5,39,139,0.2805755395683453
train,inclusion_189.xml,200,200,inclusion,76,1,113,138,94.5,69.5,37,137,0.27007299270072993
train,inclusion_189.xml,200,200,inclusion,115,45,129,86,122.0,65.5,14,41,0.34146341463414637
train,inclusion_19.xml,200,200,inclusion,127,1,152,179,139.5,90.0,25,178,0.1404494382022472
train,inclusion_19.xml,200,200,inclusion,173,1,199,91,186.0,46.0,26,90,0.28888888888888886
train,inclusion_19.xml,200,200,inclusion,176,81,192,148,184.0,114.5,16,67,0.23880597014925373
train,inclusion_190.xml,200,200,inclusion,15,31,28,69,21.5,50.0,13,38,0.34210526315789475
train,inclusion_190.xml,200,200,inclusion,26,41,59,198,42.5,119.5,33,157,0.21019108280254778
train,inclusion_190.xml,200,200,inclusion,59,12,103,198,81.0,105.0,44,186,0.23655913978494625
train,inclusion_190.xml,200,200,inclusion,134,1,149,43,141.5,22.0,15,42,0.35714285714285715
train,inclusion_191.xml,200,200,inclusion,150,16,166,59,158.0,37.5,16,43,0.37209302325581395
train,inclusion_191.xml,200,200,inclusion,163,29,197,197,180.0,113.0,34,168,0.20238095238095238
train,inclusion_192.xml,200,200,inclusion,6,1,36,66,21.0,33.5,30,65,0.46153846153846156
train,inclusion_192.xml,200,200,inclusion,24,64,52,188,38.0,126.0,28,124,0.22580645161290322
train,inclusion_192.xml,200,200,inclusion,51,1,71,63,61.0,32.0,20,62,0.3225806451612903
train,inclusion_193.xml,200,200,inclusion,121,20,145,131,133.0,75.5,24,111,0.21621621621621623
train,inclusion_193.xml,200,200,inclusion,147,1,190,151,168.5,76.0,43,150,0.2866666666666667
train,inclusion_194.xml,200,200,inclusion,30,69,56,194,43.0,131.5,26,125,0.208
train,inclusion_194.xml,200,200,inclusion,122,40,148,117,135.0,78.5,26,77,0.33766233766233766
train,inclusion_195.xml,200,200,inclusion,56,54,94,167,75.0,110.5,38,113,0.336283185840708
train,inclusion_196.xml,200,200,inclusion,34,63,52,113,43.0,88.0,18,50,0.36
train,inclusion_196.xml,200,200,inclusion,125,8,151,198,138.0,103.0,26,190,0.1368421052631579
train,inclusion_196.xml,200,200,inclusion,166,75,198,196,182.0,135.5,32,121,0.2644628099173554
train,inclusion_197.xml,200,200,inclusion,71,25,115,198,93.0,111.5,44,173,0.2543352601156069
train,inclusion_198.xml,200,200,inclusion,53,10,115,198,84.0,104.0,62,188,0.32978723404255317
train,inclusion_198.xml,200,200,inclusion,157,118,175,157,166.0,137.5,18,39,0.46153846153846156
train,inclusion_199.xml,200,200,inclusion,26,1,46,51,36.0,26.0,20,50,0.4
train,inclusion_199.xml,200,200,inclusion,46,1,85,197,65.5,99.0,39,196,0.1989795918367347
train,inclusion_2.xml,200,200,inclusion,23,98,39,132,31.0,115.0,16,34,0.47058823529411764
train,inclusion_2.xml,200,200,inclusion,106,166,132,199,119.0,182.5,26,33,0.7878787878787878
train,inclusion_20.xml,200,200,inclusion,64,1,100,198,82.0,99.5,36,197,0.18274111675126903
train,inclusion_20.xml,200,200,inclusion,123,1,149,160,136.0,80.5,26,159,0.16352201257861634
train,inclusion_20.xml,200,200,inclusion,124,157,142,200,133.0,178.5,18,43,0.4186046511627907
train,inclusion_20.xml,200,200,inclusion,162,48,198,198,180.0,123.0,36,150,0.24
train,inclusion_200.xml,200,200,inclusion,135,1,181,198,158.0,99.5,46,197,0.233502538071066
train,inclusion_201.xml,200,200,inclusion,52,1,105,198,78.5,99.5,53,197,0.26903553299492383
train,inclusion_201.xml,200,200,inclusion,117,94,139,168,128.0,131.0,22,74,0.2972972972972973
train,inclusion_202.xml,200,200,inclusion,27,1,82,199,54.5,100.0,55,198,0.2777777777777778
train,inclusion_203.xml,200,200,inclusion,33,3,76,197,54.5,100.0,43,194,0.22164948453608246
train,inclusion_204.xml,200,200,inclusion,18,174,38,198,28.0,186.0,20,24,0.8333333333333334
train,inclusion_204.xml,200,200,inclusion,111,38,136,154,123.5,96.0,25,116,0.21551724137931033
train,inclusion_205.xml,200,200,inclusion,20,64,45,184,32.5,124.0,25,120,0.20833333333333334
train,inclusion_205.xml,200,200,inclusion,127,11,170,198,148.5,104.5,43,187,0.22994652406417113
train,inclusion_206.xml,200,200,inclusion,25,113,45,184,35.0,148.5,20,71,0.28169014084507044
train,inclusion_206.xml,200,200,inclusion,76,97,96,160,86.0,128.5,20,63,0.31746031746031744
train,inclusion_206.xml,200,200,inclusion,172,1,192,78,182.0,39.5,20,77,0.2597402597402597
train,inclusion_207.xml,200,200,inclusion,74,14,102,140,88.0,77.0,28,126,0.2222222222222222
train,inclusion_207.xml,200,200,inclusion,103,8,150,187,126.5,97.5,47,179,0.26256983240223464
train,inclusion_208.xml,200,200,inclusion,42,1,107,198,74.5,99.5,65,197,0.3299492385786802
train,inclusion_209.xml,200,200,inclusion,33,3,104,198,68.5,100.5,71,195,0.3641025641025641
train,inclusion_21.xml,200,200,inclusion,19,163,37,199,28.0,181.0,18,36,0.5
train,inclusion_21.xml,200,200,inclusion,51,1,94,193,72.5,97.0,43,192,0.22395833333333334
train,inclusion_21.xml,200,200,inclusion,105,1,132,198,118.5,99.5,27,197,0.13705583756345177
train,inclusion_21.xml,200,200,inclusion,143,1,190,196,166.5,98.5,47,195,0.24102564102564103
train,inclusion_210.xml,200,200,inclusion,90,31,133,171,111.5,101.0,43,140,0.30714285714285716
train,inclusion_211.xml,200,200,inclusion,71,1,125,199,98.0,100.0,54,198,0.2727272727272727
train,inclusion_212.xml,200,200,inclusion,43,43,78,163,60.5,103.0,35,120,0.2916666666666667
train,inclusion_212.xml,200,200,inclusion,162,85,185,126,173.5,105.5,23,41,0.5609756097560976
train,inclusion_213.xml,200,200,inclusion,28,79,49,128,38.5,103.5,21,49,0.42857142857142855
train,inclusion_213.xml,200,200,inclusion,119,24,147,199,133.0,111.5,28,175,0.16
train,inclusion_214.xml,200,200,inclusion,38,140,56,182,47.0,161.0,18,42,0.42857142857142855
train,inclusion_214.xml,200,200,inclusion,70,26,108,197,89.0,111.5,38,171,0.2222222222222222
train,inclusion_215.xml,200,200,inclusion,59,13,83,199,71.0,106.0,24,186,0.12903225806451613
train,inclusion_215.xml,200,200,inclusion,77,1,126,199,101.5,100.0,49,198,0.2474747474747475
train,inclusion_216.xml,200,200,inclusion,44,1,107,197,75.5,99.0,63,196,0.32142857142857145
train,inclusion_216.xml,200,200,inclusion,147,67,168,110,157.5,88.5,21,43,0.4883720930232558
train,inclusion_217.xml,200,200,inclusion,42,1,108,195,75.0,98.0,66,194,0.3402061855670103
train,inclusion_218.xml,200,200,inclusion,56,71,93,144,74.5,107.5,37,73,0.5068493150684932
train,inclusion_218.xml,200,200,inclusion,89,73,113,112,101.0,92.5,24,39,0.6153846153846154
train,inclusion_218.xml,200,200,inclusion,109,65,139,145,124.0,105.0,30,80,0.375
train,inclusion_219.xml,200,200,inclusion,87,52,108,91,97.5,71.5,21,39,0.5384615384615384
train,inclusion_219.xml,200,200,inclusion,110,93,133,179,121.5,136.0,23,86,0.26744186046511625
train,inclusion_22.xml,200,200,inclusion,24,20,45,103,34.5,61.5,21,83,0.25301204819277107
train,inclusion_22.xml,200,200,inclusion,48,4,94,181,71.0,92.5,46,177,0.2598870056497175
train,inclusion_22.xml,200,200,inclusion,99,52,124,110,111.5,81.0,25,58,0.43103448275862066
train,inclusion_22.xml,200,200,inclusion,144,2,189,188,166.5,95.0,45,186,0.24193548387096775
train,inclusion_220.xml,200,200,inclusion,41,5,57,33,49.0,19.0,16,28,0.5714285714285714
train,inclusion_220.xml,200,200,inclusion,53,11,96,199,74.5,105.0,43,188,0.22872340425531915
train,inclusion_221.xml,200,200,inclusion,35,61,61,195,48.0,128.0,26,134,0.19402985074626866
train,inclusion_221.xml,200,200,inclusion,127,11,143,34,135.0,22.5,16,23,0.6956521739130435
train,inclusion_221.xml,200,200,inclusion,138,12,182,199,160.0,105.5,44,187,0.23529411764705882
train,inclusion_222.xml,200,200,inclusion,27,177,49,199,38.0,188.0,22,22,1.0
train,inclusion_222.xml,200,200,inclusion,122,30,149,166,135.5,98.0,27,136,0.19852941176470587
train,inclusion_223.xml,200,200,inclusion,53,14,79,177,66.0,95.5,26,163,0.15950920245398773
train,inclusion_223.xml,200,200,inclusion,84,111,102,142,93.0,126.5,18,31,0.5806451612903226
train,inclusion_223.xml,200,200,inclusion,110,1,131,63,120.5,32.0,21,62,0.3387096774193548
train,inclusion_224.xml,200,200,inclusion,70,26,87,67,78.5,46.5,17,41,0.4146341463414634
train,inclusion_224.xml,200,200,inclusion,79,42,126,198,102.5,120.0,47,156,0.30128205128205127
train,inclusion_225.xml,200,200,inclusion,28,2,64,194,46.0,98.0,36,192,0.1875
train,inclusion_225.xml,200,200,inclusion,68,14,84,74,76.0,44.0,16,60,0.26666666666666666
train,inclusion_226.xml,200,200,inclusion,29,16,67,199,48.0,107.5,38,183,0.20765027322404372
train,inclusion_227.xml,200,200,inclusion,30,155,48,199,39.0,177.0,18,44,0.4090909090909091
train,inclusion_227.xml,200,200,inclusion,65,2,95,65,80.0,33.5,30,63,0.47619047619047616
train,inclusion_228.xml,200,200,inclusion,93,94,108,130,100.5,112.0,15,36,0.4166666666666667
train,inclusion_229.xml,200,200,inclusion,31,23,58,184,44.5,103.5,27,161,0.16770186335403728
train,inclusion_23.xml,200,200,inclusion,23,10,93,199,58.0,104.5,70,189,0.37037037037037035
train,inclusion_23.xml,200,200,inclusion,109,98,132,198,120.5,148.0,23,100,0.23
train,inclusion_23.xml,200,200,inclusion,164,67,194,190,179.0,128.5,30,123,0.24390243902439024
train,inclusion_230.xml,200,200,inclusion,31,1,62,179,46.5,90.0,31,178,0.17415730337078653
train,inclusion_230.xml,200,200,inclusion,143,13,159,54,151.0,33.5,16,41,0.3902439024390244
train,inclusion_231.xml,200,200,inclusion,111,86,128,129,119.5,107.5,17,43,0.3953488372093023
train,inclusion_232.xml,200,200,inclusion,6,43,44,166,25.0,104.5,38,123,0.3089430894308943
train,inclusion_232.xml,200,200,inclusion,133,1,152,151,142.5,76.0,19,150,0.12666666666666668
train,inclusion_233.xml,200,200,inclusion,43,14,81,128,62.0,71.0,38,114,0.3333333333333333
train,inclusion_233.xml,200,200,inclusion,171,63,188,113,179.5,88.0,17,50,0.34
train,inclusion_234.xml,200,200,inclusion,83,24,131,200,107.0,112.0,48,176,0.2727272727272727
train,inclusion_235.xml,200,200,inclusion,77,94,130,179,103.5,136.5,53,85,0.6235294117647059
train,inclusion_236.xml,200,200,inclusion,14,12,72,92,43.0,52.0,58,80,0.725
train,inclusion_238.xml,200,200,inclusion,88,56,116,117,102.0,86.5,28,61,0.45901639344262296
train,inclusion_238.xml,200,200,inclusion,101,97,124,158,112.5,127.5,23,61,0.3770491803278688
train,inclusion_239.xml,200,200,inclusion,97,54,114,90,105.5,72.0,17,36,0.4722222222222222
train,inclusion_24.xml,200,200,inclusion,18,1,53,199,35.5,100.0,35,198,0.17676767676767677
train,inclusion_24.xml,200,200,inclusion,62,1,121,198,91.5,99.5,59,197,0.29949238578680204
train,inclusion_24.xml,200,200,inclusion,131,1,171,194,151.0,97.5,40,193,0.20725388601036268
train,inclusion_25.xml,200,200,inclusion,13,3,44,200,28.5,101.5,31,197,0.15736040609137056
train,inclusion_25.xml,200,200,inclusion,60,1,83,46,71.5,23.5,23,45,0.5111111111111111
train,inclusion_25.xml,200,200,inclusion,105,2,143,167,124.0,84.5,38,165,0.23030303030303031
train,inclusion_25.xml,200,200,inclusion,173,105,193,175,183.0,140.0,20,70,0.2857142857142857
train,inclusion_26.xml,200,200,inclusion,8,54,23,92,15.5,73.0,15,38,0.39473684210526316
train,inclusion_26.xml,200,200,inclusion,24,147,40,199,32.0,173.0,16,52,0.3076923076923077
train,inclusion_26.xml,200,200,inclusion,80,18,114,143,97.0,80.5,34,125,0.272
train,inclusion_27.xml,200,200,inclusion,14,72,37,126,25.5,99.0,23,54,0.42592592592592593
train,inclusion_27.xml,200,200,inclusion,52,23,79,197,65.5,110.0,27,174,0.15517241379310345
train,inclusion_27.xml,200,200,inclusion,92,1,129,170,110.5,85.5,37,169,0.21893491124260356
train,inclusion_27.xml,200,200,inclusion,146,46,172,156,159.0,101.0,26,110,0.23636363636363636
train,inclusion_28.xml,200,200,inclusion,35,1,69,198,52.0,99.5,34,197,0.17258883248730963
train,inclusion_28.xml,200,200,inclusion,86,13,129,199,107.5,106.0,43,186,0.23118279569892472
train,inclusion_28.xml,200,200,inclusion,143,30,168,193,155.5,111.5,25,163,0.15337423312883436
train,inclusion_28.xml,200,200,inclusion,180,101,196,144,188.0,122.5,16,43,0.37209302325581395
train,inclusion_29.xml,200,200,inclusion,54,5,92,196,73.0,100.5,38,191,0.19895287958115182
train,inclusion_29.xml,200,200,inclusion,102,16,145,197,123.5,106.5,43,181,0.23756906077348067
train,inclusion_29.xml,200,200,inclusion,171,7,193,164,182.0,85.5,22,157,0.14012738853503184
train,inclusion_3.xml,200,200,inclusion,18,16,45,186,31.5,101.0,27,170,0.1588235294117647
train,inclusion_30.xml,200,200,inclusion,87,2,124,187,105.5,94.5,37,185,0.2
train,inclusion_31.xml,200,200,inclusion,2,74,26,148,14.0,111.0,24,74,0.32432432432432434
train,inclusion_31.xml,200,200,inclusion,50,1,82,141,66.0,71.0,32,140,0.22857142857142856
train,inclusion_31.xml,200,200,inclusion,122,1,181,192,151.5,96.5,59,191,0.3089005235602094
train,inclusion_32.xml,200,200,inclusion,35,1,71,199,53.0,100.0,36,198,0.18181818181818182
train,inclusion_32.xml,200,200,inclusion,88,1,119,139,103.5,70.0,31,138,0.2246376811594203
train,inclusion_32.xml,200,200,inclusion,114,87,136,165,125.0,126.0,22,78,0.28205128205128205
train,inclusion_32.xml,200,200,inclusion,141,1,170,67,155.5,34.0,29,66,0.4393939393939394
train,inclusion_33.xml,200,200,inclusion,66,5,98,196,82.0,100.5,32,191,0.16753926701570682
train,inclusion_33.xml,200,200,inclusion,113,4,144,111,128.5,57.5,31,107,0.2897196261682243
train,inclusion_33.xml,200,200,inclusion,142,55,167,129,154.5,92.0,25,74,0.33783783783783783
train,inclusion_34.xml,200,200,inclusion,20,41,54,171,37.0,106.0,34,130,0.26153846153846155
train,inclusion_34.xml,200,200,inclusion,69,10,109,163,89.0,86.5,40,153,0.26143790849673204
train,inclusion_34.xml,200,200,inclusion,129,72,166,182,147.5,127.0,37,110,0.33636363636363636
train,inclusion_35.xml,200,200,inclusion,118,5,157,196,137.5,100.5,39,191,0.20418848167539266
train,inclusion_35.xml,200,200,inclusion,148,2,191,196,169.5,99.0,43,194,0.22164948453608246
train,inclusion_36.xml,200,200,inclusion,38,2,109,197,73.5,99.5,71,195,0.3641025641025641
train,inclusion_36.xml,200,200,inclusion,120,3,153,199,136.5,101.0,33,196,0.1683673469387755
train,inclusion_36.xml,200,200,inclusion,174,1,199,152,186.5,76.5,25,151,0.16556291390728478
train,inclusion_37.xml,200,200,inclusion,8,3,48,197,28.0,100.0,40,194,0.20618556701030927
train,inclusion_37.xml,200,200,inclusion,63,2,95,198,79.0,100.0,32,196,0.16326530612244897
train,inclusion_37.xml,200,200,inclusion,120,3,163,197,141.5,100.0,43,194,0.22164948453608246
train,inclusion_37.xml,200,200,inclusion,174,2,193,147,183.5,74.5,19,145,0.1310344827586207
train,inclusion_38.xml,200,200,inclusion,17,1,64,199,40.5,100.0,47,198,0.23737373737373738
train,inclusion_38.xml,200,200,inclusion,71,77,92,147,81.5,112.0,21,70,0.3
train,inclusion_38.xml,200,200,inclusion,105,75,120,105,112.5,90.0,15,30,0.5
train,inclusion_38.xml,200,200,inclusion,143,2,181,197,162.0,99.5,38,195,0.19487179487179487
train,inclusion_39.xml,200,200,inclusion,12,21,40,193,26.0,107.0,28,172,0.16279069767441862
train,inclusion_39.xml,200,200,inclusion,48,5,85,142,66.5,73.5,37,137,0.27007299270072993
train,inclusion_39.xml,200,200,inclusion,114,2,149,192,131.5,97.0,35,190,0.18421052631578946
train,inclusion_4.xml,200,200,inclusion,91,2,119,140,105.0,71.0,28,138,0.2028985507246377
train,inclusion_40.xml,200,200,inclusion,16,4,44,111,30.0,57.5,28,107,0.2616822429906542
train,inclusion_40.xml,200,200,inclusion,65,29,104,199,84.5,114.0,39,170,0.22941176470588234
train,inclusion_41.xml,200,200,inclusion,56,57,82,123,69.0,90.0,26,66,0.3939393939393939
train,inclusion_41.xml,200,200,inclusion,89,1,126,191,107.5,96.0,37,190,0.19473684210526315
train,inclusion_41.xml,200,200,inclusion,130,1,174,159,152.0,80.0,44,158,0.27848101265822783
train,inclusion_41.xml,200,200,inclusion,182,4,198,155,190.0,79.5,16,151,0.10596026490066225
train,inclusion_42.xml,200,200,inclusion,7,30,28,102,17.5,66.0,21,72,0.2916666666666667
train,inclusion_42.xml,200,200,inclusion,36,6,62,89,49.0,47.5,26,83,0.3132530120481928
train,inclusion_42.xml,200,200,inclusion,122,114,146,191,134.0,152.5,24,77,0.3116883116883117
train,inclusion_42.xml,200,200,inclusion,160,60,176,102,168.0,81.0,16,42,0.38095238095238093
train,inclusion_43.xml,200,200,inclusion,1,1,23,196,12.0,98.5,22,195,0.11282051282051282
train,inclusion_43.xml,200,200,inclusion,18,3,78,195,48.0,99.0,60,192,0.3125
train,inclusion_43.xml,200,200,inclusion,96,1,124,160,110.0,80.5,28,159,0.1761006289308176
train,inclusion_43.xml,200,200,inclusion,148,1,184,149,166.0,75.0,36,148,0.24324324324324326
train,inclusion_44.xml,200,200,inclusion,32,32,70,181,51.0,106.5,38,149,0.2550335570469799
train,inclusion_44.xml,200,200,inclusion,116,6,162,199,139.0,102.5,46,193,0.23834196891191708
train,inclusion_45.xml,200,200,inclusion,2,8,44,148,23.0,78.0,42,140,0.3
train,inclusion_45.xml,200,200,inclusion,53,1,120,197,86.5,99.0,67,196,0.34183673469387754
train,inclusion_45.xml,200,200,inclusion,148,54,172,113,160.0,83.5,24,59,0.4067796610169492
train,inclusion_46.xml,200,200,inclusion,27,1,54,167,40.5,84.0,27,166,0.16265060240963855
train,inclusion_46.xml,200,200,inclusion,59,9,97,196,78.0,102.5,38,187,0.20320855614973263
train,inclusion_47.xml,200,200,inclusion,99,1,136,198,117.5,99.5,37,197,0.18781725888324874
train,inclusion_47.xml,200,200,inclusion,139,1,172,181,155.5,91.0,33,180,0.18333333333333332
train,inclusion_48.xml,200,200,inclusion,48,1,83,198,65.5,99.5,35,197,0.17766497461928935
train,inclusion_48.xml,200,200,inclusion,86,1,111,155,98.5,78.0,25,154,0.16233766233766234
train,inclusion_49.xml,200,200,inclusion,133,3,178,197,155.5,100.0,45,194,0.23195876288659795
train,inclusion_5.xml,200,200,inclusion,140,11,168,90,154.0,50.5,28,79,0.35443037974683544
train,inclusion_5.xml,200,200,inclusion,141,89,166,186,153.5,137.5,25,97,0.25773195876288657
train,inclusion_50.xml,200,200,inclusion,77,1,118,196,97.5,98.5,41,195,0.21025641025641026
train,inclusion_51.xml,200,200,inclusion,30,2,70,197,50.0,99.5,40,195,0.20512820512820512
train,inclusion_52.xml,200,200,inclusion,81,1,124,197,102.5,99.0,43,196,0.2193877551020408
train,inclusion_53.xml,200,200,inclusion,22,1,58,172,40.0,86.5,36,171,0.21052631578947367
train,inclusion_54.xml,200,200,inclusion,79,1,108,90,93.5,45.5,29,89,0.3258426966292135
train,inclusion_54.xml,200,200,inclusion,82,77,116,199,99.0,138.0,34,122,0.2786885245901639
train,inclusion_55.xml,200,200,inclusion,139,1,183,198,161.0,99.5,44,197,0.2233502538071066
train,inclusion_56.xml,200,200,inclusion,9,1,51,180,30.0,90.5,42,179,0.2346368715083799
train,inclusion_56.xml,200,200,inclusion,51,1,79,198,65.0,99.5,28,197,0.14213197969543148
train,inclusion_57.xml,200,200,inclusion,99,104,123,168,111.0,136.0,24,64,0.375
train,inclusion_57.xml,200,200,inclusion,145,18,178,176,161.5,97.0,33,158,0.2088607594936709
train,inclusion_58.xml,200,200,inclusion,61,88,83,149,72.0,118.5,22,61,0.36065573770491804
train,inclusion_58.xml,200,200,inclusion,109,75,139,160,124.0,117.5,30,85,0.35294117647058826
train,inclusion_59.xml,200,200,inclusion,19,16,48,173,33.5,94.5,29,157,0.18471337579617833
train,inclusion_59.xml,200,200,inclusion,104,6,146,114,125.0,60.0,42,108,0.3888888888888889
train,inclusion_59.xml,200,200,inclusion,143,94,164,136,153.5,115.0,21,42,0.5
train,inclusion_6.xml,200,200,inclusion,1,165,136,190,68.5,177.5,135,25,5.4
train,inclusion_6.xml,200,200,inclusion,147,83,200,183,173.5,133.0,53,100,0.53
train,inclusion_60.xml,200,200,inclusion,30,1,55,200,42.5,100.5,25,199,0.12562814070351758
train,inclusion_60.xml,200,200,inclusion,132,1,174,198,153.0,99.5,42,197,0.2131979695431472
train,inclusion_61.xml,200,200,inclusion,60,1,93,159,76.5,80.0,33,158,0.2088607594936709
train,inclusion_61.xml,200,200,inclusion,84,37,119,199,101.5,118.0,35,162,0.21604938271604937
train,inclusion_62.xml,200,200,inclusion,1,66,33,199,17.0,132.5,32,133,0.24060150375939848
train,inclusion_62.xml,200,200,inclusion,39,1,67,198,53.0,99.5,28,197,0.14213197969543148
train,inclusion_62.xml,200,200,inclusion,147,1,189,197,168.0,99.0,42,196,0.21428571428571427
train,inclusion_63.xml,200,200,inclusion,143,41,168,116,155.5,78.5,25,75,0.3333333333333333
train,inclusion_63.xml,200,200,inclusion,147,108,164,179,155.5,143.5,17,71,0.23943661971830985
train,inclusion_64.xml,200,200,inclusion,106,1,138,198,122.0,99.5,32,197,0.16243654822335024
train,inclusion_65.xml,200,200,inclusion,27,1,57,145,42.0,73.0,30,144,0.20833333333333334
train,inclusion_65.xml,200,200,inclusion,147,20,191,198,169.0,109.0,44,178,0.24719101123595505
train,inclusion_66.xml,200,200,inclusion,64,1,108,197,86.0,99.0,44,196,0.22448979591836735
train,inclusion_67.xml,200,200,inclusion,17,116,39,193,28.0,154.5,22,77,0.2857142857142857
train,inclusion_67.xml,200,200,inclusion,71,31,97,92,84.0,61.5,26,61,0.4262295081967213
train,inclusion_67.xml,200,200,inclusion,126,1,155,200,140.5,100.5,29,199,0.1457286432160804
train,inclusion_68.xml,200,200,inclusion,92,109,118,161,105.0,135.0,26,52,0.5
train,inclusion_68.xml,200,200,inclusion,154,6,171,66,162.5,36.0,17,60,0.2833333333333333
train,inclusion_69.xml,200,200,inclusion,30,30,56,167,43.0,98.5,26,137,0.1897810218978102
train,inclusion_69.xml,200,200,inclusion,141,71,165,146,153.0,108.5,24,75,0.32
train,inclusion_7.xml,200,200,inclusion,9,56,147,83,78.0,69.5,138,27,5.111111111111111
train,inclusion_7.xml,200,200,inclusion,151,61,183,75,167.0,68.0,32,14,2.2857142857142856
train,inclusion_70.xml,200,200,inclusion,24,5,73,179,48.5,92.0,49,174,0.28160919540229884
train,inclusion_70.xml,200,200,inclusion,86,46,117,179,101.5,112.5,31,133,0.23308270676691728
train,inclusion_71.xml,200,200,inclusion,76,73,114,158,95.0,115.5,38,85,0.4470588235294118
train,inclusion_71.xml,200,200,inclusion,110,66,136,112,123.0,89.0,26,46,0.5652173913043478
train,inclusion_72.xml,200,200,inclusion,92,40,125,113,108.5,76.5,33,73,0.4520547945205479
train,inclusion_73.xml,200,200,inclusion,75,1,108,129,91.5,65.0,33,128,0.2578125
train,inclusion_73.xml,200,200,inclusion,127,109,157,180,142.0,144.5,30,71,0.4225352112676056
train,inclusion_74.xml,200,200,inclusion,85,1,116,196,100.5,98.5,31,195,0.15897435897435896
train,inclusion_74.xml,200,200,inclusion,121,2,144,88,132.5,45.0,23,86,0.26744186046511625
train,inclusion_74.xml,200,200,inclusion,147,18,167,50,157.0,34.0,20,32,0.625
train,inclusion_75.xml,200,200,inclusion,7,2,40,197,23.5,99.5,33,195,0.16923076923076924
train,inclusion_75.xml,200,200,inclusion,43,76,67,164,55.0,120.0,24,88,0.2727272727272727
train,inclusion_75.xml,200,200,inclusion,69,97,89,127,79.0,112.0,20,30,0.6666666666666666
train,inclusion_75.xml,200,200,inclusion,115,23,133,78,124.0,50.5,18,55,0.32727272727272727
train,inclusion_76.xml,200,200,inclusion,80,1,128,198,104.0,99.5,48,197,0.2436548223350254
train,inclusion_76.xml,200,200,inclusion,130,115,155,194,142.5,154.5,25,79,0.31645569620253167
train,inclusion_76.xml,200,200,inclusion,158,135,174,164,166.0,149.5,16,29,0.5517241379310345
train,inclusion_77.xml,200,200,inclusion,77,69,123,198,100.0,133.5,46,129,0.35658914728682173
train,inclusion_78.xml,200,200,inclusion,2,49,29,99,15.5,74.0,27,50,0.54
train,inclusion_78.xml,200,200,inclusion,99,1,141,199,120.0,100.0,42,198,0.21212121212121213
train,inclusion_79.xml,200,200,inclusion,17,6,65,196,41.0,101.0,48,190,0.25263157894736843
train,inclusion_8.xml,200,200,inclusion,23,143,52,160,37.5,151.5,29,17,1.7058823529411764
train,inclusion_8.xml,200,200,inclusion,65,132,198,164,131.5,148.0,133,32,4.15625
train,inclusion_80.xml,200,200,inclusion,34,65,73,197,53.5,131.0,39,132,0.29545454545454547
train,inclusion_80.xml,200,200,inclusion,131,11,160,132,145.5,71.5,29,121,0.2396694214876033
train,inclusion_80.xml,200,200,inclusion,157,68,198,197,177.5,132.5,41,129,0.3178294573643411
train,inclusion_81.xml,200,200,inclusion,10,11,43,68,26.5,39.5,33,57,0.5789473684210527
train,inclusion_81.xml,200,200,inclusion,44,1,90,199,67.0,100.0,46,198,0.23232323232323232
train,inclusion_81.xml,200,200,inclusion,136,1,188,198,162.0,99.5,52,197,0.2639593908629442
train,inclusion_82.xml,200,200,inclusion,35,1,87,199,61.0,100.0,52,198,0.26262626262626265
train,inclusion_83.xml,200,200,inclusion,120,52,133,88,126.5,70.0,13,36,0.3611111111111111
train,inclusion_83.xml,200,200,inclusion,144,1,190,187,167.0,94.0,46,186,0.24731182795698925
train,inclusion_84.xml,200,200,inclusion,85,170,101,200,93.0,185.0,16,30,0.5333333333333333
train,inclusion_84.xml,200,200,inclusion,111,6,134,168,122.5,87.0,23,162,0.1419753086419753
train,inclusion_84.xml,200,200,inclusion,133,84,162,199,147.5,141.5,29,115,0.25217391304347825
train,inclusion_84.xml,200,200,inclusion,158,1,184,132,171.0,66.5,26,131,0.1984732824427481
train,inclusion_85.xml,200,200,inclusion,9,94,25,127,17.0,110.5,16,33,0.48484848484848486
train,inclusion_85.xml,200,200,inclusion,30,1,92,193,61.0,97.0,62,192,0.3229166666666667
train,inclusion_85.xml,200,200,inclusion,129,19,162,114,145.5,66.5,33,95,0.3473684210526316
train,inclusion_86.xml,200,200,inclusion,7,43,37,175,22.0,109.0,30,132,0.22727272727272727
train,inclusion_86.xml,200,200,inclusion,35,1,72,192,53.5,96.5,37,191,0.193717277486911
train,inclusion_86.xml,200,200,inclusion,110,21,144,110,127.0,65.5,34,89,0.38202247191011235
train,inclusion_87.xml,200,200,inclusion,19,117,39,167,29.0,142.0,20,50,0.4
train,inclusion_87.xml,200,200,inclusion,45,83,67,119,56.0,101.0,22,36,0.6111111111111112
train,inclusion_87.xml,200,200,inclusion,67,36,95,165,81.0,100.5,28,129,0.21705426356589147
train,inclusion_87.xml,200,200,inclusion,92,1,134,181,113.0,91.0,42,180,0.23333333333333334
train,inclusion_87.xml,200,200,inclusion,167,24,190,106,178.5,65.0,23,82,0.2804878048780488
train,inclusion_88.xml,200,200,inclusion,34,56,49,170,41.5,113.0,15,114,0.13157894736842105
train,inclusion_88.xml,200,200,inclusion,61,27,79,75,70.0,51.0,18,48,0.375
train,inclusion_88.xml,200,200,inclusion,83,1,130,188,106.5,94.5,47,187,0.25133689839572193
train,inclusion_88.xml,200,200,inclusion,135,47,175,129,155.0,88.0,40,82,0.4878048780487805
train,inclusion_89.xml,200,200,inclusion,28,21,43,104,35.5,62.5,15,83,0.18072289156626506
train,inclusion_89.xml,200,200,inclusion,75,58,115,123,95.0,90.5,40,65,0.6153846153846154
train,inclusion_89.xml,200,200,inclusion,126,1,157,98,141.5,49.5,31,97,0.31958762886597936
train,inclusion_89.xml,200,200,inclusion,166,137,188,177,177.0,157.0,22,40,0.55
train,inclusion_9.xml,200,200,inclusion,1,64,122,93,61.5,78.5,121,29,4.172413793103448
train,inclusion_90.xml,200,200,inclusion,35,1,72,91,53.5,46.0,37,90,0.4111111111111111
train,inclusion_91.xml,200,200,inclusion,25,1,65,186,45.0,93.5,40,185,0.21621621621621623
train,inclusion_91.xml,200,200,inclusion,69,44,108,114,88.5,79.0,39,70,0.5571428571428572
train,inclusion_92.xml,200,200,inclusion,29,32,61,77,45.0,54.5,32,45,0.7111111111111111
train,inclusion_92.xml,200,200,inclusion,79,1,96,37,87.5,19.0,17,36,0.4722222222222222
train,inclusion_92.xml,200,200,inclusion,120,45,170,180,145.0,112.5,50,135,0.37037037037037035
train,inclusion_93.xml,200,200,inclusion,42,22,76,133,59.0,77.5,34,111,0.3063063063063063
train,inclusion_93.xml,200,200,inclusion,85,89,115,184,100.0,136.5,30,95,0.3157894736842105
train,inclusion_93.xml,200,200,inclusion,150,25,179,182,164.5,103.5,29,157,0.18471337579617833
train,inclusion_94.xml,200,200,inclusion,8,2,43,198,25.5,100.0,35,196,0.17857142857142858
train,inclusion_94.xml,200,200,inclusion,69,9,99,88,84.0,48.5,30,79,0.379746835443038
train,inclusion_94.xml,200,200,inclusion,105,30,159,184,132.0,107.0,54,154,0.35064935064935066
train,inclusion_95.xml,200,200,inclusion,37,4,67,131,52.0,67.5,30,127,0.23622047244094488
train,inclusion_95.xml,200,200,inclusion,136,9,175,147,155.5,78.0,39,138,0.2826086956521739
train,inclusion_96.xml,200,200,inclusion,30,58,60,199,45.0,128.5,30,141,0.2127659574468085
train,inclusion_96.xml,200,200,inclusion,119,57,156,160,137.5,108.5,37,103,0.3592233009708738
train,inclusion_97.xml,200,200,inclusion,150,26,188,154,169.0,90.0,38,128,0.296875
train,inclusion_98.xml,200,200,inclusion,38,1,109,198,73.5,99.5,71,197,0.3604060913705584
train,inclusion_99.xml,200,200,inclusion,109,3,180,198,144.5,100.5,71,195,0.3641025641025641
train,patches_1.xml,200,200,patches,43,10,106,97,74.5,53.5,63,87,0.7241379310344828
train,patches_1.xml,200,200,patches,32,91,81,148,56.5,119.5,49,57,0.8596491228070176
train,patches_1.xml,200,200,patches,23,156,62,198,42.5,177.0,39,42,0.9285714285714286
train,patches_10.xml,200,200,patches,9,88,49,140,29.0,114.0,40,52,0.7692307692307693
train,patches_10.xml,200,200,patches,124,1,173,117,148.5,59.0,49,116,0.4224137931034483
train,patches_100.xml,200,200,patches,1,73,21,132,11.0,102.5,20,59,0.3389830508474576
train,patches_100.xml,200,200,patches,109,1,160,111,134.5,56.0,51,110,0.4636363636363636
train,patches_100.xml,200,200,patches,120,117,163,186,141.5,151.5,43,69,0.6231884057971014
train,patches_101.xml,200,200,patches,27,1,78,92,52.5,46.5,51,91,0.5604395604395604
train,patches_101.xml,200,200,patches,113,1,175,59,144.0,30.0,62,58,1.0689655172413792
train,patches_101.xml,200,200,patches,129,79,176,200,152.5,139.5,47,121,0.3884297520661157
train,patches_102.xml,200,200,patches,20,53,94,139,57.0,96.0,74,86,0.8604651162790697
train,patches_102.xml,200,200,patches,126,108,166,156,146.0,132.0,40,48,0.8333333333333334
train,patches_103.xml,200,200,patches,64,30,117,181,90.5,105.5,53,151,0.3509933774834437
train,patches_104.xml,200,200,patches,1,88,41,200,21.0,144.0,40,112,0.35714285714285715
train,patches_104.xml,200,200,patches,50,107,84,157,67.0,132.0,34,50,0.68
train,patches_104.xml,200,200,patches,129,26,168,94,148.5,60.0,39,68,0.5735294117647058
train,patches_104.xml,200,200,patches,152,140,199,200,175.5,170.0,47,60,0.7833333333333333
train,patches_105.xml,200,200,patches,29,1,76,92,52.5,46.5,47,91,0.5164835164835165
train,patches_105.xml,200,200,patches,116,1,174,53,145.0,27.0,58,52,1.1153846153846154
train,patches_105.xml,200,200,patches,130,78,173,200,151.5,139.0,43,122,0.3524590163934426
train,patches_106.xml,200,200,patches,75,67,108,139,91.5,103.0,33,72,0.4583333333333333
train,patches_107.xml,200,200,patches,97,9,152,111,124.5,60.0,55,102,0.5392156862745098
train,patches_107.xml,200,200,patches,69,1,103,14,86.0,7.5,34,13,2.6153846153846154
train,patches_108.xml,200,200,patches,8,1,64,122,36.0,61.5,56,121,0.4628099173553719
train,patches_108.xml,200,200,patches,75,1,177,111,126.0,56.0,102,110,0.9272727272727272
train,patches_108.xml,200,200,patches,145,117,190,187,167.5,152.0,45,70,0.6428571428571429
train,patches_109.xml,200,200,patches,1,124,23,153,12.0,138.5,22,29,0.7586206896551724
train,patches_109.xml,200,200,patches,67,20,130,170,98.5,95.0,63,150,0.42
train,patches_109.xml,200,200,patches,176,116,200,157,188.0,136.5,24,41,0.5853658536585366
train,patches_11.xml,200,200,patches,1,65,50,164,25.5,114.5,49,99,0.494949494949495
train,patches_11.xml,200,200,patches,158,65,192,168,175.0,116.5,34,103,0.3300970873786408
train,patches_110.xml,200,200,patches,11,94,47,137,29.0,115.5,36,43,0.8372093023255814
train,patches_110.xml,200,200,patches,61,68,140,165,100.5,116.5,79,97,0.8144329896907216
train,patches_111.xml,200,200,patches,53,147,102,199,77.5,173.0,49,52,0.9423076923076923
train,patches_111.xml,200,200,patches,132,1,195,178,163.5,89.5,63,177,0.3559322033898305
train,patches_112.xml,200,200,patches,48,136,96,174,72.0,155.0,48,38,1.263157894736842
train,patches_112.xml,200,200,patches,58,9,100,77,79.0,43.0,42,68,0.6176470588235294
train,patches_112.xml,200,200,patches,132,24,181,76,156.5,50.0,49,52,0.9423076923076923
train,patches_112.xml,200,200,patches,132,80,200,199,166.0,139.5,68,119,0.5714285714285714
train,patches_113.xml,200,200,patches,4,71,78,167,41.0,119.0,74,96,0.7708333333333334
train,patches_113.xml,200,200,patches,135,39,181,76,158.0,57.5,46,37,1.2432432432432432
train,patches_114.xml,200,200,patches,1,1,88,113,44.5,57.0,87,112,0.7767857142857143
train,patches_114.xml,200,200,patches,58,120,102,189,80.0,154.5,44,69,0.6376811594202898
train,patches_114.xml,200,200,patches,131,125,182,198,156.5,161.5,51,73,0.6986301369863014
train,patches_114.xml,200,200,patches,130,28,178,98,154.0,63.0,48,70,0.6857142857142857
train,patches_114.xml,200,200,patches,148,1,192,29,170.0,15.0,44,28,1.5714285714285714
train,patches_115.xml,200,200,patches,16,93,92,200,54.0,146.5,76,107,0.7102803738317757
train,patches_115.xml,200,200,patches,111,127,161,179,136.0,153.0,50,52,0.9615384615384616
train,patches_115.xml,200,200,patches,56,6,92,62,74.0,34.0,36,56,0.6428571428571429
train,patches_115.xml,200,200,patches,147,41,198,133,172.5,87.0,51,92,0.5543478260869565
train,patches_116.xml,200,200,patches,27,4,92,200,59.5,102.0,65,196,0.33163265306122447
train,patches_116.xml,200,200,patches,114,62,196,200,155.0,131.0,82,138,0.5942028985507246
train,patches_116.xml,200,200,patches,163,1,194,29,178.5,15.0,31,28,1.1071428571428572
train,patches_117.xml,200,200,patches,1,68,51,123,26.0,95.5,50,55,0.9090909090909091
train,patches_117.xml,200,200,patches,82,83,155,160,118.5,121.5,73,77,0.948051948051948
train,patches_118.xml,200,200,patches,6,18,90,91,48.0,54.5,84,73,1.1506849315068493
train,patches_118.xml,200,200,patches,129,10,198,200,163.5,105.0,69,190,0.3631578947368421
train,patches_118.xml,200,200,patches,87,68,172,199,129.5,133.5,85,131,0.648854961832061
train,patches_119.xml,200,200,patches,1,2,80,199,40.5,100.5,79,197,0.4010152284263959
train,patches_119.xml,200,200,patches,148,1,186,43,167.0,22.0,38,42,0.9047619047619048
train,patches_119.xml,200,200,patches,104,89,200,199,152.0,144.0,96,110,0.8727272727272727
train,patches_12.xml,200,200,patches,15,154,46,200,30.5,177.0,31,46,0.6739130434782609
train,patches_12.xml,200,200,patches,89,78,166,166,127.5,122.0,77,88,0.875
train,patches_12.xml,200,200,patches,125,14,164,63,144.5,38.5,39,49,0.7959183673469388
train,patches_120.xml,200,200,patches,41,1,83,73,62.0,37.0,42,72,0.5833333333333334
train,patches_120.xml,200,200,patches,105,1,183,86,144.0,43.5,78,85,0.9176470588235294
train,patches_120.xml,200,200,patches,34,91,83,200,58.5,145.5,49,109,0.44954128440366975
train,patches_120.xml,200,200,patches,85,70,147,200,116.0,135.0,62,130,0.47692307692307695
train,patches_120.xml,200,200,patches,1,154,22,198,11.5,176.0,21,44,0.4772727272727273
train,patches_121.xml,200,200,patches,135,1,192,193,163.5,97.0,57,192,0.296875
train,patches_122.xml,200,200,patches,14,1,54,29,34.0,15.0,40,28,1.4285714285714286
train,patches_122.xml,200,200,patches,68,30,106,63,87.0,46.5,38,33,1.1515151515151516
train,patches_122.xml,200,200,patches,112,3,158,72,135.0,37.5,46,69,0.6666666666666666
train,patches_122.xml,200,200,patches,72,75,156,176,114.0,125.5,84,101,0.8316831683168316
train,patches_123.xml,200,200,patches,56,16,144,198,100.0,107.0,88,182,0.4835164835164835
train,patches_123.xml,200,200,patches,152,146,190,198,171.0,172.0,38,52,0.7307692307692307
train,patches_124.xml,200,200,patches,3,1,86,178,44.5,89.5,83,177,0.4689265536723164
train,patches_124.xml,200,200,patches,96,28,194,167,145.0,97.5,98,139,0.7050359712230215
train,patches_125.xml,200,200,patches,1,160,33,200,17.0,180.0,32,40,0.8
train,patches_125.xml,200,200,patches,128,1,184,111,156.0,56.0,56,110,0.509090909090909
train,patches_126.xml,200,200,patches,66,24,121,166,93.5,95.0,55,142,0.3873239436619718
train,patches_127.xml,200,200,patches,1,170,44,199,22.5,184.5,43,29,1.4827586206896552
train,patches_127.xml,200,200,patches,1,1,160,129,80.5,65.0,159,128,1.2421875
train,patches_127.xml,200,200,patches,148,122,188,197,168.0,159.5,40,75,0.5333333333333333
train,patches_127.xml,200,200,patches,144,1,192,130,168.0,65.5,48,129,0.37209302325581395
train,patches_128.xml,200,200,patches,1,42,52,184,26.5,113.0,51,142,0.3591549295774648
train,patches_128.xml,200,200,patches,148,61,190,109,169.0,85.0,42,48,0.875
train,patches_128.xml,200,200,patches,146,1,190,59,168.0,30.0,44,58,0.7586206896551724
train,patches_128.xml,200,200,patches,169,179,200,199,184.5,189.0,31,20,1.55
train,patches_128.xml,200,200,patches,1,1,28,16,14.5,8.5,27,15,1.8
train,patches_129.xml,200,200,patches,38,34,69,109,53.5,71.5,31,75,0.41333333333333333
train,patches_13.xml,200,200,patches,64,69,116,178,90.0,123.5,52,109,0.47706422018348627
train,patches_130.xml,200,200,patches,21,17,64,189,42.5,103.0,43,172,0.25
train,patches_130.xml,200,200,patches,116,87,192,199,154.0,143.0,76,112,0.6785714285714286
train,patches_130.xml,200,200,patches,161,1,187,16,174.0,8.5,26,15,1.7333333333333334
train,patches_131.xml,200,200,patches,23,154,45,176,34.0,165.0,22,22,1.0
train,patches_131.xml,200,200,patches,57,73,82,105,69.5,89.0,25,32,0.78125
train,patches_131.xml,200,200,patches,67,120,144,200,105.5,160.0,77,80,0.9625
train,patches_132.xml,200,200,patches,16,1,59,111,37.5,56.0,43,110,0.39090909090909093
train,patches_132.xml,200,200,patches,109,14,189,191,149.0,102.5,80,177,0.4519774011299435
train,patches_133.xml,200,200,patches,58,1,130,38,94.0,19.5,72,37,1.945945945945946
train,patches_133.xml,200,200,patches,103,35,136,94,119.5,64.5,33,59,0.559322033898305
train,patches_133.xml,200,200,patches,64,172,131,199,97.5,185.5,67,27,2.4814814814814814
train,patches_134.xml,200,200,patches,53,36,124,174,88.5,105.0,71,138,0.5144927536231884
train,patches_134.xml,200,200,patches,155,118,200,194,177.5,156.0,45,76,0.5921052631578947
train,patches_135.xml,200,200,patches,73,27,110,94,91.5,60.5,37,67,0.5522388059701493
train,patches_136.xml,200,200,patches,76,1,132,199,104.0,100.0,56,198,0.2828282828282828
train,patches_137.xml,200,200,patches,21,48,101,123,61.0,85.5,80,75,1.0666666666666667
train,patches_137.xml,200,200,patches,99,51,179,190,139.0,120.5,80,139,0.5755395683453237
train,patches_138.xml,200,200,patches,24,99,109,199,66.5,149.0,85,100,0.85
train,patches_138.xml,200,200,patches,64,1,133,89,98.5,45.0,69,88,0.7840909090909091
train,patches_138.xml,200,200,patches,1,1,43,22,22.0,11.5,42,21,2.0
train,patches_139.xml,200,200,patches,40,85,107,188,73.5,136.5,67,103,0.6504854368932039
train,patches_139.xml,200,200,patches,135,124,190,179,162.5,151.5,55,55,1.0
train,patches_139.xml,200,200,patches,62,11,87,55,74.5,33.0,25,44,0.5681818181818182
train,patches_14.xml,200,200,patches,78,71,150,127,114.0,99.0,72,56,1.2857142857142858
train,patches_140.xml,200,200,patches,5,1,70,56,37.5,28.5,65,55,1.1818181818181819
train,patches_140.xml,200,200,patches,20,118,65,192,42.5,155.0,45,74,0.6081081081081081
train,patches_140.xml,200,200,patches,82,127,141,193,111.5,160.0,59,66,0.8939393939393939
train,patches_140.xml,200,200,patches,98,1,154,42,126.0,21.5,56,41,1.3658536585365855
train,patches_140.xml,200,200,patches,154,10,200,199,177.0,104.5,46,189,0.24338624338624337
train,patches_141.xml,200,200,patches,71,104,98,130,84.5,117.0,27,26,1.0384615384615385
train,patches_141.xml,200,200,patches,131,14,179,90,155.0,52.0,48,76,0.631578947368421
train,patches_141.xml,200,200,patches,129,106,190,200,159.5,153.0,61,94,0.648936170212766
train,patches_142.xml,200,200,patches,1,13,47,88,24.0,50.5,46,75,0.6133333333333333
train,patches_142.xml,200,200,patches,1,106,60,199,30.5,152.5,59,93,0.6344086021505376
train,patches_142.xml,200,200,patches,63,26,128,107,95.5,66.5,65,81,0.8024691358024691
train,patches_142.xml,200,200,patches,130,1,197,161,163.5,81.0,67,160,0.41875
train,patches_142.xml,200,200,patches,100,127,179,199,139.5,163.0,79,72,1.0972222222222223
train,patches_143.xml,200,200,patches,35,6,125,163,80.0,84.5,90,157,0.5732484076433121
train,patches_143.xml,200,200,patches,1,20,30,54,15.5,37.0,29,34,0.8529411764705882
train,patches_143.xml,200,200,patches,39,173,80,200,59.5,186.5,41,27,1.5185185185185186
train,patches_144.xml,200,200,patches,17,47,74,139,45.5,93.0,57,92,0.6195652173913043
train,patches_144.xml,200,200,patches,80,10,167,118,123.5,64.0,87,108,0.8055555555555556
train,patches_145.xml,200,200,patches,6,1,76,67,41.0,34.0,70,66,1.0606060606060606
train,patches_145.xml,200,200,patches,4,76,65,200,34.5,138.0,61,124,0.49193548387096775
train,patches_145.xml,200,200,patches,109,1,174,80,141.5,40.5,65,79,0.8227848101265823
train,patches_145.xml,200,200,patches,113,69,190,199,151.5,134.0,77,130,0.5923076923076923
train,patches_146.xml,200,200,patches,1,1,66,79,33.5,40.0,65,78,0.8333333333333334
train,patches_146.xml,200,200,patches,6,68,74,200,40.0,134.0,68,132,0.5151515151515151
train,patches_146.xml,200,200,patches,139,1,178,48,158.5,24.5,39,47,0.8297872340425532
train,patches_147.xml,200,200,patches,40,1,88,76,64.0,38.5,48,75,0.64
train,patches_147.xml,200,200,patches,43,88,103,199,73.0,143.5,60,111,0.5405405405405406
train,patches_147.xml,200,200,patches,161,1,200,199,180.5,100.0,39,198,0.19696969696969696
train,patches_148.xml,200,200,patches,1,42,41,146,21.0,94.0,40,104,0.38461538461538464
train,patches_148.xml,200,200,patches,62,1,144,189,103.0,95.0,82,188,0.43617021276595747
train,patches_149.xml,200,200,patches,38,3,136,194,87.0,98.5,98,191,0.5130890052356021
train,patches_149.xml,200,200,patches,137,47,199,199,168.0,123.0,62,152,0.40789473684210525
train,patches_149.xml,200,200,patches,155,1,198,56,176.5,28.5,43,55,0.7818181818181819
train,patches_15.xml,200,200,patches,59,1,112,52,85.5,26.5,53,51,1.0392156862745099
train,patches_15.xml,200,200,patches,67,75,109,200,88.0,137.5,42,125,0.336
train,patches_150.xml,200,200,patches,3,1,59,157,31.0,79.0,56,156,0.358974358974359
train,patches_150.xml,200,200,patches,1,161,51,200,26.0,180.5,50,39,1.2820512820512822
train,patches_150.xml,200,200,patches,118,1,194,200,156.0,100.5,76,199,0.38190954773869346
train,patches_151.xml,200,200,patches,27,1,87,196,57.0,98.5,60,195,0.3076923076923077
train,patches_151.xml,200,200,patches,1,1,27,91,14.0,46.0,26,90,0.28888888888888886
train,patches_151.xml,200,200,patches,78,103,127,188,102.5,145.5,49,85,0.5764705882352941
train,patches_151.xml,200,200,patches,150,1,200,200,175.0,100.5,50,199,0.25125628140703515
train,patches_152.xml,200,200,patches,19,1,73,79,46.0,40.0,54,78,0.6923076923076923
train,patches_152.xml,200,200,patches,7,103,32,149,19.5,126.0,25,46,0.5434782608695652
train,patches_152.xml,200,200,patches,95,157,132,200,113.5,178.5,37,43,0.8604651162790697
train,patches_152.xml,200,200,patches,152,149,200,200,176.0,174.5,48,51,0.9411764705882353
train,patches_152.xml,200,200,patches,96,1,142,110,119.0,55.5,46,109,0.42201834862385323
train,patches_152.xml,200,200,patches,144,21,195,104,169.5,62.5,51,83,0.6144578313253012
train,patches_153.xml,200,200,patches,27,53,132,157,79.5,105.0,105,104,1.0096153846153846
train,patches_154.xml,200,200,patches,28,1,73,63,50.5,32.0,45,62,0.7258064516129032
train,patches_154.xml,200,200,patches,41,78,74,140,57.5,109.0,33,62,0.532258064516129
train,patches_154.xml,200,200,patches,133,85,156,118,144.5,101.5,23,33,0.696969696969697
train,patches_155.xml,200,200,patches,1,1,60,156,30.5,78.5,59,155,0.38064516129032255
train,patches_155.xml,200,200,patches,62,1,116,25,89.0,13.0,54,24,2.25
train,patches_155.xml,200,200,patches,134,1,193,99,163.5,50.0,59,98,0.6020408163265306
train,patches_155.xml,200,200,patches,131,136,177,200,154.0,168.0,46,64,0.71875
train,patches_155.xml,200,200,inclusion,75,42,130,120,102.5,81.0,55,78,0.7051282051282052
train,patches_155.xml,200,200,inclusion,154,108,182,143,168.0,125.5,28,35,0.8
train,patches_156.xml,200,200,patches,94,61,127,86,110.5,73.5,33,25,1.32
train,patches_156.xml,200,200,patches,92,105,129,189,110.5,147.0,37,84,0.44047619047619047
train,patches_157.xml,200,200,patches,50,1,148,190,99.0,95.5,98,189,0.5185185185185185
train,patches_157.xml,200,200,patches,1,1,37,106,19.0,53.5,36,105,0.34285714285714286
train,patches_158.xml,200,200,patches,7,1,87,198,47.0,99.5,80,197,0.40609137055837563
train,patches_158.xml,200,200,patches,103,1,190,198,146.5,99.5,87,197,0.4416243654822335
train,patches_159.xml,200,200,patches,116,14,158,70,137.0,42.0,42,56,0.75
train,patches_159.xml,200,200,patches,113,142,154,199,133.5,170.5,41,57,0.7192982456140351
train,patches_16.xml,200,200,patches,2,45,43,200,22.5,122.5,41,155,0.2645161290322581
train,patches_16.xml,200,200,patches,135,149,176,200,155.5,174.5,41,51,0.803921568627451
train,patches_16.xml,200,200,patches,1,1,50,56,25.5,28.5,49,55,0.8909090909090909
train,patches_160.xml,200,200,patches,122,139,169,200,145.5,169.5,47,61,0.7704918032786885
train,patches_161.xml,200,200,patches,66,1,150,75,108.0,38.0,84,74,1.135135135135135
train,patches_162.xml,200,200,patches,22,109,101,196,61.5,152.5,79,87,0.9080459770114943
train,patches_163.xml,200,200,patches,104,1,148,42,126.0,21.5,44,41,1.0731707317073171
train,patches_163.xml,200,200,patches,1,1,67,25,34.0,13.0,66,24,2.75
train,patches_164.xml,200,200,patches,102,45,180,163,141.0,104.0,78,118,0.6610169491525424
train,patches_165.xml,200,200,patches,44,73,106,197,75.0,135.0,62,124,0.5
train,patches_165.xml,200,200,patches,183,14,200,92,191.5,53.0,17,78,0.21794871794871795
train,patches_165.xml,200,200,patches,1,155,22,200,11.5,177.5,21,45,0.4666666666666667
train,patches_165.xml,200,200,patches,165,155,199,200,182.0,177.5,34,45,0.7555555555555555
train,patches_166.xml,200,200,patches,34,4,74,86,54.0,45.0,40,82,0.4878048780487805
train,patches_166.xml,200,200,patches,101,17,179,170,140.0,93.5,78,153,0.5098039215686274
train,patches_166.xml,200,200,patches,25,159,55,199,40.0,179.0,30,40,0.75
train,patches_167.xml,200,200,patches,39,1,102,132,70.5,66.5,63,131,0.48091603053435117
train,patches_167.xml,200,200,patches,108,1,165,115,136.5,58.0,57,114,0.5
train,patches_167.xml,200,200,patches,168,1,200,85,184.0,43.0,32,84,0.38095238095238093
train,patches_167.xml,200,200,inclusion,149,126,170,145,159.5,135.5,21,19,1.105263157894737
train,patches_167.xml,200,200,inclusion,176,154,200,180,188.0,167.0,24,26,0.9230769230769231
train,patches_168.xml,200,200,patches,34,75,78,177,56.0,126.0,44,102,0.43137254901960786
train,patches_168.xml,200,200,patches,121,90,178,156,149.5,123.0,57,66,0.8636363636363636
train,patches_168.xml,200,200,patches,133,1,200,62,166.5,31.5,67,61,1.098360655737705
train,patches_168.xml,200,200,inclusion,1,108,30,149,15.5,128.5,29,41,0.7073170731707317
train,patches_168.xml,200,200,inclusion,79,54,104,74,91.5,64.0,25,20,1.25
train,patches_168.xml,200,200,inclusion,149,78,200,169,174.5,123.5,51,91,0.5604395604395604
train,patches_169.xml,200,200,patches,17,9,93,149,55.0,79.0,76,140,0.5428571428571428
train,patches_169.xml,200,200,patches,100,33,158,199,129.0,116.0,58,166,0.3493975903614458
train,patches_17.xml,200,200,patches,22,13,69,198,45.5,105.5,47,185,0.25405405405405407
train,patches_17.xml,200,200,patches,113,1,182,128,147.5,64.5,69,127,0.5433070866141733
train,patches_17.xml,200,200,patches,106,134,183,199,144.5,166.5,77,65,1.1846153846153846
train,patches_170.xml,200,200,patches,54,1,140,96,97.0,48.5,86,95,0.9052631578947369
train,patches_171.xml,200,200,patches,1,54,62,90,31.5,72.0,61,36,1.6944444444444444
train,patches_171.xml,200,200,patches,94,1,170,75,132.0,38.0,76,74,1.027027027027027
train,patches_171.xml,200,200,patches,74,109,184,199,129.0,154.0,110,90,1.2222222222222223
train,patches_171.xml,200,200,inclusion,144,47,198,119,171.0,83.0,54,72,0.75
train,patches_172.xml,200,200,patches,21,23,75,146,48.0,84.5,54,123,0.43902439024390244
train,patches_172.xml,200,200,patches,16,163,71,200,43.5,181.5,55,37,1.4864864864864864
train,patches_172.xml,200,200,patches,105,87,166,155,135.5,121.0,61,68,0.8970588235294118
train,patches_172.xml,200,200,patches,164,65,200,149,182.0,107.0,36,84,0.42857142857142855
train,patches_172.xml,200,200,inclusion,160,1,200,184,180.0,92.5,40,183,0.2185792349726776
train,patches_173.xml,200,200,patches,20,55,84,173,52.0,114.0,64,118,0.5423728813559322
train,patches_174.xml,200,200,patches,11,1,68,200,39.5,100.5,57,199,0.2864321608040201
train,patches_174.xml,200,200,patches,132,1,200,200,166.0,100.5,68,199,0.3417085427135678
train,patches_174.xml,200,200,inclusion,1,122,21,178,11.0,150.0,20,56,0.35714285714285715
train,patches_174.xml,200,200,inclusion,102,88,125,111,113.5,99.5,23,23,1.0
train,patches_175.xml,200,200,patches,10,12,117,110,63.5,61.0,107,98,1.0918367346938775
train,patches_175.xml,200,200,patches,1,116,53,200,27.0,158.0,52,84,0.6190476190476191
train,patches_175.xml,200,200,patches,129,1,193,200,161.0,100.5,64,199,0.32160804020100503
train,patches_175.xml,200,200,inclusion,74,7,138,199,106.0,103.0,64,192,0.3333333333333333
train,patches_176.xml,200,200,patches,20,1,80,198,50.0,99.5,60,197,0.30456852791878175
train,patches_176.xml,200,200,patches,149,1,199,53,174.0,27.0,50,52,0.9615384615384616
train,patches_176.xml,200,200,inclusion,1,17,24,172,12.5,94.5,23,155,0.14838709677419354
train,patches_176.xml,200,200,inclusion,162,4,182,22,172.0,13.0,20,18,1.1111111111111112
train,patches_177.xml,200,200,patches,49,46,135,175,92.0,110.5,86,129,0.6666666666666666
train,patches_177.xml,200,200,patches,139,60,199,182,169.0,121.0,60,122,0.4918032786885246
train,patches_177.xml,200,200,patches,141,1,182,48,161.5,24.5,41,47,0.8723404255319149
train,patches_178.xml,200,200,patches,61,6,140,162,100.5,84.0,79,156,0.5064102564102564
train,patches_179.xml,200,200,patches,89,1,137,59,113.0,30.0,48,58,0.8275862068965517
train,patches_179.xml,200,200,patches,14,101,132,193,73.0,147.0,118,92,1.2826086956521738
train,patches_179.xml,200,200,inclusion,50,23,92,192,71.0,107.5,42,169,0.2485207100591716
train,patches_18.xml,200,200,patches,42,1,108,78,75.0,39.5,66,77,0.8571428571428571
train,patches_18.xml,200,200,patches,116,47,183,108,149.5,77.5,67,61,1.098360655737705
train,patches_18.xml,200,200,patches,50,116,97,200,73.5,158.0,47,84,0.5595238095238095
train,patches_180.xml,200,200,patches,1,52,34,118,17.5,85.0,33,66,0.5
train,patches_180.xml,200,200,patches,62,13,109,131,85.5,72.0,47,118,0.3983050847457627
train,patches_180.xml,200,200,patches,112,1,154,48,133.0,24.5,42,47,0.8936170212765957
train,patches_181.xml,200,200,patches,4,5,87,73,45.5,39.0,83,68,1.2205882352941178
train,patches_181.xml,200,200,patches,102,86,156,165,129.0,125.5,54,79,0.6835443037974683
train,patches_181.xml,200,200,patches,126,10,200,76,163.0,43.0,74,66,1.121212121212121
train,patches_181.xml,200,200,patches,54,156,95,198,74.5,177.0,41,42,0.9761904761904762
train,patches_182.xml,200,200,patches,50,16,136,139,93.0,77.5,86,123,0.6991869918699187
train,patches_183.xml,200,200,patches,42,32,121,199,81.5,115.5,79,167,0.47305389221556887
train,patches_183.xml,200,200,patches,125,1,199,133,162.0,67.0,74,132,0.5606060606060606
train,patches_184.xml,200,200,patches,34,96,137,186,85.5,141.0,103,90,1.1444444444444444
train,patches_184.xml,200,200,patches,89,1,126,51,107.5,26.0,37,50,0.74
train,patches_184.xml,200,200,patches,161,1,200,21,180.5,11.0,39,20,1.95
train,patches_184.xml,200,200,patches,1,97,28,152,14.5,124.5,27,55,0.4909090909090909
train,patches_184.xml,200,200,inclusion,84,62,121,200,102.5,131.0,37,138,0.26811594202898553
train,patches_185.xml,200,200,patches,52,1,122,168,87.0,84.5,70,167,0.41916167664670656
train,patches_186.xml,200,200,patches,37,1,102,131,69.5,66.0,65,130,0.5
train,patches_186.xml,200,200,patches,122,56,200,159,161.0,107.5,78,103,0.7572815533980582
train,patches_186.xml,200,200,patches,57,140,119,198,88.0,169.0,62,58,1.0689655172413792
train,patches_187.xml,200,200,patches,59,1,117,114,88.0,57.5,58,113,0.5132743362831859
train,patches_187.xml,200,200,patches,1,62,55,133,28.0,97.5,54,71,0.7605633802816901
train,patches_187.xml,200,200,patches,64,155,112,200,88.0,177.5,48,45,1.0666666666666667
train,patches_187.xml,200,200,inclusion,32,109,64,179,48.0,144.0,32,70,0.45714285714285713
train,patches_187.xml,200,200,inclusion,165,35,190,113,177.5,74.0,25,78,0.32051282051282054
train,patches_188.xml,200,200,patches,1,1,61,106,31.0,53.5,60,105,0.5714285714285714
train,patches_188.xml,200,200,patches,1,130,52,199,26.5,164.5,51,69,0.7391304347826086
train,patches_188.xml,200,200,patches,138,1,200,181,169.0,91.0,62,180,0.34444444444444444
train,patches_188.xml,200,200,inclusion,1,19,25,39,13.0,29.0,24,20,1.2
train,patches_188.xml,200,200,inclusion,112,91,136,124,124.0,107.5,24,33,0.7272727272727273
train,patches_189.xml,200,200,patches,64,98,115,166,89.5,132.0,51,68,0.75
train,patches_189.xml,200,200,patches,55,1,107,75,81.0,38.0,52,74,0.7027027027027027
train,patches_189.xml,200,200,patches,108,40,161,71,134.5,55.5,53,31,1.7096774193548387
train,patches_189.xml,200,200,patches,122,75,193,200,157.5,137.5,71,125,0.568
train,patches_19.xml,200,200,patches,20,1,72,140,46.0,70.5,52,139,0.37410071942446044
train,patches_19.xml,200,200,patches,94,38,180,200,137.0,119.0,86,162,0.5308641975308642
train,patches_19.xml,200,200,patches,24,142,105,199,64.5,170.5,81,57,1.4210526315789473
train,patches_19.xml,200,200,patches,115,1,186,37,150.5,19.0,71,36,1.9722222222222223
train,patches_190.xml,200,200,patches,21,1,82,154,51.5,77.5,61,153,0.39869281045751637
train,patches_190.xml,200,200,patches,130,21,200,63,165.0,42.0,70,42,1.6666666666666667
train,patches_190.xml,200,200,patches,123,101,200,185,161.5,143.0,77,84,0.9166666666666666
train,patches_190.xml,200,200,patches,23,151,71,200,47.0,175.5,48,49,0.9795918367346939
train,patches_190.xml,200,200,inclusion,6,12,27,43,16.5,27.5,21,31,0.6774193548387096
train,patches_190.xml,200,200,inclusion,136,58,160,99,148.0,78.5,24,41,0.5853658536585366
train,patches_190.xml,200,200,inclusion,172,71,194,97,183.0,84.0,22,26,0.8461538461538461
train,patches_191.xml,200,200,patches,27,14,79,91,53.0,52.5,52,77,0.6753246753246753
train,patches_191.xml,200,200,patches,31,117,103,200,67.0,158.5,72,83,0.8674698795180723
train,patches_191.xml,200,200,patches,91,2,184,198,137.5,100.0,93,196,0.4744897959183674
train,patches_192.xml,200,200,patches,41,70,163,189,102.0,129.5,122,119,1.0252100840336134
train,patches_192.xml,200,200,patches,33,7,84,75,58.5,41.0,51,68,0.75
train,patches_192.xml,200,200,patches,92,1,148,79,120.0,40.0,56,78,0.717948717948718
train,patches_192.xml,200,200,patches,1,91,47,168,24.0,129.5,46,77,0.5974025974025974
train,patches_193.xml,200,200,patches,62,4,136,72,99.0,38.0,74,68,1.088235294117647
train,patches_193.xml,200,200,patches,72,96,125,167,98.5,131.5,53,71,0.7464788732394366
train,patches_193.xml,200,200,patches,130,76,195,200,162.5,138.0,65,124,0.5241935483870968
train,patches_193.xml,200,200,patches,107,35,179,75,143.0,55.0,72,40,1.8
train,patches_194.xml,200,200,patches,72,1,144,199,108.0,100.0,72,198,0.36363636363636365
train,patches_194.xml,200,200,patches,146,1,200,83,173.0,42.0,54,82,0.6585365853658537
train,patches_195.xml,200,200,patches,1,1,59,146,30.0,73.5,58,145,0.4
train,patches_195.xml,200,200,patches,45,57,170,197,107.5,127.0,125,140,0.8928571428571429
train,patches_195.xml,200,200,patches,133,8,178,51,155.5,29.5,45,43,1.0465116279069768
train,patches_195.xml,200,200,patches,121,139,180,200,150.5,169.5,59,61,0.9672131147540983
train,patches_195.xml,200,200,inclusion,83,20,109,43,96.0,31.5,26,23,1.1304347826086956
train,patches_195.xml,200,200,inclusion,113,77,144,104,128.5,90.5,31,27,1.1481481481481481
train,patches_196.xml,200,200,patches,51,1,107,53,79.0,27.0,56,52,1.0769230769230769
train,patches_196.xml,200,200,patches,50,55,124,200,87.0,127.5,74,145,0.5103448275862069
train,patches_197.xml,200,200,patches,1,1,61,26,31.0,13.5,60,25,2.4
train,patches_197.xml,200,200,patches,1,66,54,193,27.5,129.5,53,127,0.41732283464566927
train,patches_197.xml,200,200,patches,111,36,187,133,149.0,84.5,76,97,0.7835051546391752
train,patches_198.xml,200,200,patches,21,1,99,198,60.0,99.5,78,197,0.39593908629441626
train,patches_198.xml,200,200,patches,158,68,200,158,179.0,113.0,42,90,0.4666666666666667
train,patches_198.xml,200,200,patches,109,64,154,140,131.5,102.0,45,76,0.5921052631578947
train,patches_198.xml,200,200,inclusion,1,21,21,50,11.0,35.5,20,29,0.6896551724137931
train,patches_199.xml,200,200,patches,6,6,163,131,84.5,68.5,157,125,1.256
train,patches_199.xml,200,200,patches,91,120,142,199,116.5,159.5,51,79,0.6455696202531646
train,patches_199.xml,200,200,inclusion,55,148,116,195,85.5,171.5,61,47,1.297872340425532
train,patches_2.xml,200,200,patches,36,1,98,152,67.0,76.5,62,151,0.4105960264900662
train,patches_2.xml,200,200,patches,115,52,174,190,144.5,121.0,59,138,0.427536231884058
train,patches_2.xml,200,200,patches,113,1,200,26,156.5,13.5,87,25,3.48
train,patches_20.xml,200,200,patches,56,1,115,191,85.5,96.0,59,190,0.3105263157894737
train,patches_200.xml,200,200,patches,3,1,73,189,38.0,95.0,70,188,0.3723404255319149
train,patches_200.xml,200,200,patches,133,1,200,157,166.5,79.0,67,156,0.42948717948717946
train,patches_201.xml,200,200,patches,18,17,170,134,94.0,75.5,152,117,1.2991452991452992
train,patches_201.xml,200,200,patches,1,1,50,30,25.5,15.5,49,29,1.6896551724137931
train,patches_201.xml,200,200,patches,95,124,155,185,125.0,154.5,60,61,0.9836065573770492
train,patches_201.xml,200,200,inclusion,63,140,131,197,97.0,168.5,68,57,1.1929824561403508
train,patches_202.xml,200,200,patches,30,1,183,89,106.5,45.0,153,88,1.7386363636363635
train,patches_202.xml,200,200,patches,20,108,85,199,52.5,153.5,65,91,0.7142857142857143
train,patches_202.xml,200,200,patches,145,64,185,153,165.0,108.5,40,89,0.449438202247191
train,patches_202.xml,200,200,patches,94,158,121,188,107.5,173.0,27,30,0.9
train,patches_202.xml,200,200,inclusion,101,121,133,147,117.0,134.0,32,26,1.2307692307692308
train,patches_203.xml,200,200,patches,57,127,122,200,89.5,163.5,65,73,0.8904109589041096
train,patches_203.xml,200,200,patches,29,1,122,119,75.5,60.0,93,118,0.788135593220339
train,patches_204.xml,200,200,patches,48,1,110,200,79.0,100.5,62,199,0.31155778894472363
train,patches_204.xml,200,200,patches,160,14,199,98,179.5,56.0,39,84,0.4642857142857143
train,patches_205.xml,200,200,patches,1,1,74,96,37.5,48.5,73,95,0.7684210526315789
train,patches_205.xml,200,200,patches,1,103,70,200,35.5,151.5,69,97,0.711340206185567
train,patches_205.xml,200,200,patches,108,58,195,200,151.5,129.0,87,142,0.6126760563380281
train,patches_206.xml,200,200,patches,1,1,42,98,21.5,49.5,41,97,0.422680412371134
train,patches_206.xml,200,200,patches,75,97,116,166,95.5,131.5,41,69,0.5942028985507246
train,patches_206.xml,200,200,patches,140,1,200,180,170.0,90.5,60,179,0.33519553072625696
train,patches_206.xml,200,200,inclusion,123,99,141,126,132.0,112.5,18,27,0.6666666666666666
train,patches_207.xml,200,200,patches,62,1,131,114,96.5,57.5,69,113,0.6106194690265486
train,patches_207.xml,200,200,patches,62,148,140,199,101.0,173.5,78,51,1.5294117647058822
train,patches_208.xml,200,200,patches,57,47,143,198,100.0,122.5,86,151,0.5695364238410596
train,patches_208.xml,200,200,patches,17,128,64,171,40.5,149.5,47,43,1.0930232558139534
train,patches_209.xml,200,200,patches,1,1,86,140,43.5,70.5,85,139,0.6115107913669064
train,patches_209.xml,200,200,patches,28,149,129,199,78.5,174.0,101,50,2.02
train,patches_209.xml,200,200,patches,89,1,180,144,134.5,72.5,91,143,0.6363636363636364
train,patches_21.xml,200,200,patches,32,1,109,180,70.5,90.5,77,179,0.4301675977653631
train,patches_21.xml,200,200,patches,119,1,190,199,154.5,100.0,71,198,0.35858585858585856
train,patches_210.xml,200,200,patches,1,1,59,200,30.0,100.5,58,199,0.2914572864321608
train,patches_210.xml,200,200,patches,61,1,200,191,130.5,96.0,139,190,0.7315789473684211
train,patches_210.xml,200,200,inclusion,109,149,147,188,128.0,168.5,38,39,0.9743589743589743
train,patches_211.xml,200,200,patches,54,1,103,154,78.5,77.5,49,153,0.3202614379084967
train,patches_211.xml,200,200,patches,95,61,185,197,140.0,129.0,90,136,0.6617647058823529
train,patches_211.xml,200,200,patches,2,1,44,16,23.0,8.5,42,15,2.8
train,patches_211.xml,200,200,patches,54,129,99,200,76.5,164.5,45,71,0.6338028169014085
train,patches_211.xml,200,200,inclusion,147,25,184,77,165.5,51.0,37,52,0.7115384615384616
train,patches_212.xml,200,200,patches,1,76,36,199,18.5,137.5,35,123,0.2845528455284553
train,patches_212.xml,200,200,patches,19,1,114,136,66.5,68.5,95,135,0.7037037037037037
train,patches_212.xml,200,200,patches,121,72,166,195,143.5,133.5,45,123,0.36585365853658536
train,patches_212.xml,200,200,patches,117,1,173,26,145.0,13.5,56,25,2.24
train,patches_213.xml,200,200,patches,104,1,165,112,134.5,56.5,61,111,0.5495495495495496
train,patches_213.xml,200,200,patches,16,1,65,64,40.5,32.5,49,63,0.7777777777777778
train,patches_214.xml,200,200,patches,48,83,119,178,83.5,130.5,71,95,0.7473684210526316
train,patches_214.xml,200,200,patches,99,56,183,127,141.0,91.5,84,71,1.1830985915492958
train,patches_215.xml,200,200,patches,7,1,85,109,46.0,55.0,78,108,0.7222222222222222
train,patches_215.xml,200,200,patches,125,1,196,131,160.5,66.0,71,130,0.5461538461538461
train,patches_215.xml,200,200,patches,1,87,67,193,34.0,140.0,66,106,0.6226415094339622
train,patches_215.xml,200,200,patches,60,65,133,200,96.5,132.5,73,135,0.5407407407407407
train,patches_215.xml,200,200,patches,135,136,197,200,166.0,168.0,62,64,0.96875
train,patches_216.xml,200,200,patches,61,1,97,28,79.0,14.5,36,27,1.3333333333333333
train,patches_216.xml,200,200,patches,113,1,168,67,140.5,34.0,55,66,0.8333333333333334
train,patches_216.xml,200,200,patches,22,96,167,164,94.5,130.0,145,68,2.1323529411764706
train,patches_216.xml,200,200,patches,118,168,158,199,138.0,183.5,40,31,1.2903225806451613
train,patches_216.xml,200,200,patches,14,122,62,199,38.0,160.5,48,77,0.6233766233766234
train,patches_216.xml,200,200,patches,177,1,200,30,188.5,15.5,23,29,0.7931034482758621
train,patches_217.xml,200,200,patches,2,1,49,66,25.5,33.5,47,65,0.7230769230769231
train,patches_217.xml,200,200,patches,1,167,32,200,16.5,183.5,31,33,0.9393939393939394
train,patches_217.xml,200,200,patches,1,95,46,169,23.5,132.0,45,74,0.6081081081081081
train,patches_217.xml,200,200,patches,70,88,163,198,116.5,143.0,93,110,0.8454545454545455
train,patches_217.xml,200,200,patches,107,1,196,104,151.5,52.5,89,103,0.8640776699029126
train,patches_217.xml,200,200,patches,55,1,103,33,79.0,17.0,48,32,1.5
train,patches_218.xml,200,200,patches,1,73,76,134,38.5,103.5,75,61,1.2295081967213115
train,patches_218.xml,200,200,patches,1,133,83,196,42.0,164.5,82,63,1.3015873015873016
train,patches_218.xml,200,200,patches,98,2,193,196,145.5,99.0,95,194,0.4896907216494845
train,patches_218.xml,200,200,patches,1,1,42,48,21.5,24.5,41,47,0.8723404255319149
train,patches_219.xml,200,200,patches,46,96,122,200,84.0,148.0,76,104,0.7307692307692307
train,patches_22.xml,200,200,patches,10,148,57,200,33.5,174.0,47,52,0.9038461538461539
train,patches_22.xml,200,200,patches,109,1,179,200,144.0,100.5,70,199,0.35175879396984927
train,patches_220.xml,200,200,patches,1,151,39,200,20.0,175.5,38,49,0.7755102040816326
train,patches_220.xml,200,200,patches,3,16,103,145,53.0,80.5,100,129,0.7751937984496124
train,patches_220.xml,200,200,patches,92,9,197,82,144.5,45.5,105,73,1.4383561643835616
train,patches_220.xml,200,200,patches,91,77,170,198,130.5,137.5,79,121,0.6528925619834711
train,patches_221.xml,200,200,patches,1,18,49,71,25.0,44.5,48,53,0.9056603773584906
train,patches_221.xml,200,200,patches,85,33,176,199,130.5,116.0,91,166,0.5481927710843374
train,patches_222.xml,200,200,patches,99,1,181,200,140.0,100.5,82,199,0.4120603015075377
train,patches_222.xml,200,200,patches,61,125,110,200,85.5,162.5,49,75,0.6533333333333333
train,patches_222.xml,200,200,patches,60,91,96,129,78.0,110.0,36,38,0.9473684210526315
train,patches_223.xml,200,200,patches,1,53,75,196,38.0,124.5,74,143,0.5174825174825175
train,patches_223.xml,200,200,patches,118,19,160,189,139.0,104.0,42,170,0.24705882352941178
train,patches_224.xml,200,200,patches,97,50,189,188,143.0,119.0,92,138,0.6666666666666666
train,patches_224.xml,200,200,patches,106,8,153,56,129.5,32.0,47,48,0.9791666666666666
train,patches_224.xml,200,200,patches,1,1,64,198,32.5,99.5,63,197,0.3197969543147208
train,patches_224.xml,200,200,patches,71,164,160,199,115.5,181.5,89,35,2.5428571428571427
train,patches_225.xml,200,200,patches,73,46,145,157,109.0,101.5,72,111,0.6486486486486487
train,patches_226.xml,200,200,patches,31,80,81,164,56.0,122.0,50,84,0.5952380952380952
train,patches_226.xml,200,200,patches,115,24,192,96,153.5,60.0,77,72,1.0694444444444444
train,patches_227.xml,200,200,patches,1,66,84,193,42.5,129.5,83,127,0.6535433070866141
train,patches_227.xml,200,200,patches,93,101,160,149,126.5,125.0,67,48,1.3958333333333333
train,patches_227.xml,200,200,patches,98,1,163,94,130.5,47.5,65,93,0.6989247311827957
train,patches_227.xml,200,200,patches,7,1,101,29,54.0,15.0,94,28,3.357142857142857
train,patches_227.xml,200,200,inclusion,166,164,194,188,180.0,176.0,28,24,1.1666666666666667
train,patches_228.xml,200,200,patches,13,110,70,176,41.5,143.0,57,66,0.8636363636363636
train,patches_228.xml,200,200,patches,79,12,160,198,119.5,105.0,81,186,0.43548387096774194
train,patches_229.xml,200,200,patches,70,6,166,190,118.0,98.0,96,184,0.5217391304347826
train,patches_229.xml,200,200,patches,1,1,61,29,31.0,15.0,60,28,2.142857142857143
train,patches_229.xml,200,200,patches,175,134,200,200,187.5,167.0,25,66,0.3787878787878788
train,patches_23.xml,200,200,patches,90,1,157,198,123.5,99.5,67,197,0.3401015228426396
train,patches_230.xml,200,200,patches,56,1,151,198,103.5,99.5,95,197,0.48223350253807107
train,patches_230.xml,200,200,patches,1,139,25,200,13.0,169.5,24,61,0.39344262295081966
train,patches_230.xml,200,200,patches,1,24,25,97,13.0,60.5,24,73,0.3287671232876712
train,patches_230.xml,200,200,patches,123,148,159,200,141.0,174.0,36,52,0.6923076923076923
train,patches_230.xml,200,200,inclusion,146,53,177,109,161.5,81.0,31,56,0.5535714285714286
train,patches_231.xml,200,200,patches,1,1,63,69,32.0,35.0,62,68,0.9117647058823529
train,patches_231.xml,200,200,patches,64,1,149,130,106.5,65.5,85,129,0.6589147286821705
train,patches_231.xml,200,200,patches,65,143,124,185,94.5,164.0,59,42,1.4047619047619047
train,patches_231.xml,200,200,patches,1,115,44,200,22.5,157.5,43,85,0.5058823529411764
train,patches_231.xml,200,200,patches,179,127,200,160,189.5,143.5,21,33,0.6363636363636364
train,patches_231.xml,200,200,patches,83,1,161,37,122.0,19.0,78,36,2.1666666666666665
train,patches_232.xml,200,200,patches,14,41,63,80,38.5,60.5,49,39,1.2564102564102564
train,patches_232.xml,200,200,patches,103,12,146,80,124.5,46.0,43,68,0.6323529411764706
train,patches_232.xml,200,200,patches,37,163,85,199,61.0,181.0,48,36,1.3333333333333333
train,patches_232.xml,200,200,patches,113,66,185,115,149.0,90.5,72,49,1.469387755102041
train,patches_232.xml,200,200,patches,1,1,40,25,20.5,13.0,39,24,1.625
train,patches_232.xml,200,200,patches,71,130,141,169,106.0,149.5,70,39,1.794871794871795
train,patches_233.xml,200,200,patches,68,12,169,153,118.5,82.5,101,141,0.7163120567375887
train,patches_233.xml,200,200,patches,26,127,111,186,68.5,156.5,85,59,1.4406779661016949
train,patches_234.xml,200,200,patches,9,1,80,94,44.5,47.5,71,93,0.7634408602150538
train,patches_234.xml,200,200,patches,15,107,83,146,49.0,126.5,68,39,1.7435897435897436
train,patches_234.xml,200,200,patches,126,72,189,121,157.5,96.5,63,49,1.2857142857142858
train,patches_234.xml,200,200,patches,12,157,75,199,43.5,178.0,63,42,1.5
train,patches_235.xml,200,200,patches,12,71,68,123,40.0,97.0,56,52,1.0769230769230769
train,patches_235.xml,200,200,patches,107,1,177,140,142.0,70.5,70,139,0.5035971223021583
train,patches_235.xml,200,200,patches,91,128,179,200,135.0,164.0,88,72,1.2222222222222223
train,patches_236.xml,200,200,patches,3,76,79,192,41.0,134.0,76,116,0.6551724137931034
train,patches_236.xml,200,200,patches,124,79,192,195,158.0,137.0,68,116,0.5862068965517241
train,patches_236.xml,200,200,patches,132,1,190,86,161.0,43.5,58,85,0.6823529411764706
train,patches_237.xml,200,200,patches,4,18,73,146,38.5,82.0,69,128,0.5390625
train,patches_237.xml,200,200,patches,1,149,74,200,37.5,174.5,73,51,1.4313725490196079
train,patches_237.xml,200,200,patches,106,8,177,196,141.5,102.0,71,188,0.3776595744680851
train,patches_238.xml,200,200,patches,61,62,122,151,91.5,106.5,61,89,0.6853932584269663
train,patches_238.xml,200,200,patches,51,1,124,52,87.5,26.5,73,51,1.4313725490196079
train,patches_239.xml,200,200,patches,97,32,162,142,129.5,87.0,65,110,0.5909090909090909
train,patches_239.xml,200,200,patches,20,118,72,153,46.0,135.5,52,35,1.4857142857142858
train,patches_24.xml,200,200,patches,1,14,37,200,19.0,107.0,36,186,0.1935483870967742
train,patches_24.xml,200,200,patches,135,10,185,76,160.0,43.0,50,66,0.7575757575757576
train,patches_24.xml,200,200,patches,155,96,198,142,176.5,119.0,43,46,0.9347826086956522
train,patches_240.xml,200,200,patches,120,126,192,187,156.0,156.5,72,61,1.180327868852459
train,patches_25.xml,200,200,patches,8,1,104,37,56.0,19.0,96,36,2.6666666666666665
train,patches_25.xml,200,200,patches,103,1,168,63,135.5,32.0,65,62,1.0483870967741935
train,patches_25.xml,200,200,patches,112,66,198,196,155.0,131.0,86,130,0.6615384615384615
train,patches_25.xml,200,200,patches,36,128,71,162,53.5,145.0,35,34,1.0294117647058822
train,patches_26.xml,200,200,patches,80,11,189,143,134.5,77.0,109,132,0.8257575757575758
train,patches_26.xml,200,200,patches,136,153,185,195,160.5,174.0,49,42,1.1666666666666667
train,patches_26.xml,200,200,patches,1,132,51,200,26.0,166.0,50,68,0.7352941176470589
train,patches_26.xml,200,200,patches,2,3,70,129,36.0,66.0,68,126,0.5396825396825397
train,patches_27.xml,200,200,patches,12,46,116,152,64.0,99.0,104,106,0.9811320754716981
train,patches_27.xml,200,200,patches,136,74,198,122,167.0,98.0,62,48,1.2916666666666667
train,patches_27.xml,200,200,patches,58,10,105,49,81.5,29.5,47,39,1.205128205128205
train,patches_28.xml,200,200,patches,7,91,89,200,48.0,145.5,82,109,0.7522935779816514
train,patches_28.xml,200,200,patches,113,141,195,199,154.0,170.0,82,58,1.4137931034482758
train,patches_28.xml,200,200,patches,25,1,84,54,54.5,27.5,59,53,1.1132075471698113
train,patches_29.xml,200,200,patches,60,1,133,88,96.5,44.5,73,87,0.8390804597701149
train,patches_29.xml,200,200,patches,71,100,131,179,101.0,139.5,60,79,0.759493670886076
train,patches_29.xml,200,200,patches,1,1,49,104,25.0,52.5,48,103,0.46601941747572817
train,patches_3.xml,200,200,patches,4,101,48,193,26.0,147.0,44,92,0.4782608695652174
train,patches_3.xml,200,200,patches,80,64,128,181,104.0,122.5,48,117,0.41025641025641024
train,patches_3.xml,200,200,patches,130,120,171,197,150.5,158.5,41,77,0.5324675324675324
train,patches_3.xml,200,200,patches,153,1,199,102,176.0,51.5,46,101,0.45544554455445546
train,patches_3.xml,200,200,patches,6,15,46,90,26.0,52.5,40,75,0.5333333333333333
train,patches_3.xml,200,200,patches,69,1,106,22,87.5,11.5,37,21,1.7619047619047619
train,patches_30.xml,200,200,patches,36,38,128,189,82.0,113.5,92,151,0.609271523178808
train,patches_30.xml,200,200,patches,176,1,200,38,188.0,19.5,24,37,0.6486486486486487
train,patches_31.xml,200,200,patches,58,63,130,185,94.0,124.0,72,122,0.5901639344262295
train,patches_31.xml,200,200,patches,137,104,189,176,163.0,140.0,52,72,0.7222222222222222
train,patches_32.xml,200,200,patches,31,85,105,151,68.0,118.0,74,66,1.121212121212121
train,patches_32.xml,200,200,patches,106,111,150,154,128.0,132.5,44,43,1.0232558139534884
train,patches_32.xml,200,200,patches,108,44,164,111,136.0,77.5,56,67,0.835820895522388
train,patches_33.xml,200,200,patches,73,1,134,77,103.5,39.0,61,76,0.8026315789473685
train,patches_33.xml,200,200,patches,67,121,128,168,97.5,144.5,61,47,1.297872340425532
train,patches_33.xml,200,200,patches,79,170,124,198,101.5,184.0,45,28,1.6071428571428572
train,patches_34.xml,200,200,patches,58,101,102,158,80.0,129.5,44,57,0.7719298245614035
train,patches_34.xml,200,200,patches,47,45,100,95,73.5,70.0,53,50,1.06
train,patches_34.xml,200,200,patches,145,123,191,167,168.0,145.0,46,44,1.0454545454545454
train,patches_35.xml,200,200,patches,44,2,93,60,68.5,31.0,49,58,0.8448275862068966
train,patches_35.xml,200,200,patches,141,29,183,73,162.0,51.0,42,44,0.9545454545454546
train,patches_35.xml,200,200,patches,51,109,100,199,75.5,154.0,49,90,0.5444444444444444
train,patches_36.xml,200,200,patches,16,101,70,135,43.0,118.0,54,34,1.588235294117647
train,patches_36.xml,200,200,patches,109,5,164,199,136.5,102.0,55,194,0.28350515463917525
train,patches_37.xml,200,200,patches,49,110,114,157,81.5,133.5,65,47,1.3829787234042554
train,patches_37.xml,200,200,patches,63,167,96,200,79.5,183.5,33,33,1.0
train,patches_38.xml,200,200,patches,11,1,67,198,39.0,99.5,56,197,0.28426395939086296
train,patches_38.xml,200,200,patches,132,108,196,159,164.0,133.5,64,51,1.2549019607843137
train,patches_38.xml,200,200,patches,145,155,183,200,164.0,177.5,38,45,0.8444444444444444
train,patches_39.xml,200,200,patches,68,47,107,97,87.5,72.0,39,50,0.78
train,patches_4.xml,200,200,patches,93,36,137,83,115.0,59.5,44,47,0.9361702127659575
train,patches_4.xml,200,200,patches,118,92,165,158,141.5,125.0,47,66,0.7121212121212122
train,patches_40.xml,200,200,patches,14,79,55,167,34.5,123.0,41,88,0.4659090909090909
train,patches_40.xml,200,200,patches,128,107,187,160,157.5,133.5,59,53,1.1132075471698113
train,patches_41.xml,200,200,patches,18,40,57,81,37.5,60.5,39,41,0.9512195121951219
train,patches_41.xml,200,200,patches,33,118,77,192,55.0,155.0,44,74,0.5945945945945946
train,patches_42.xml,200,200,patches,90,7,129,60,109.5,33.5,39,53,0.7358490566037735
train,patches_42.xml,200,200,patches,65,69,144,193,104.5,131.0,79,124,0.6370967741935484
train,patches_43.xml,200,200,patches,70,88,128,186,99.0,137.0,58,98,0.5918367346938775
train,patches_43.xml,200,200,patches,61,32,113,93,87.0,62.5,52,61,0.8524590163934426
train,patches_44.xml,200,200,patches,70,100,128,159,99.0,129.5,58,59,0.9830508474576272
train,patches_45.xml,200,200,patches,1,56,41,138,21.0,97.0,40,82,0.4878048780487805
train,patches_45.xml,200,200,patches,1,1,24,50,12.5,25.5,23,49,0.46938775510204084
train,patches_45.xml,200,200,patches,153,71,178,120,165.5,95.5,25,49,0.5102040816326531
train,patches_45.xml,200,200,patches,136,159,170,199,153.0,179.0,34,40,0.85
train,patches_46.xml,200,200,patches,69,91,125,187,97.0,139.0,56,96,0.5833333333333334
train,patches_46.xml,200,200,patches,85,2,134,84,109.5,43.0,49,82,0.5975609756097561
train,patches_46.xml,200,200,patches,145,29,177,79,161.0,54.0,32,50,0.64
train,patches_47.xml,200,200,patches,27,34,98,138,62.5,86.0,71,104,0.6826923076923077
train,patches_47.xml,200,200,patches,105,24,191,114,148.0,69.0,86,90,0.9555555555555556
train,patches_47.xml,200,200,patches,104,130,144,189,124.0,159.5,40,59,0.6779661016949152
train,patches_48.xml,200,200,patches,70,43,122,122,96.0,82.5,52,79,0.6582278481012658
train,patches_48.xml,200,200,patches,1,1,33,24,17.0,12.5,32,23,1.391304347826087
train,patches_49.xml,200,200,patches,11,2,49,58,30.0,30.0,38,56,0.6785714285714286
train,patches_49.xml,200,200,patches,6,142,56,200,31.0,171.0,50,58,0.8620689655172413
train,patches_49.xml,200,200,patches,136,1,198,126,167.0,63.5,62,125,0.496
train,patches_5.xml,200,200,patches,33,1,94,155,63.5,78.0,61,154,0.3961038961038961
train,patches_5.xml,200,200,patches,115,65,163,194,139.0,129.5,48,129,0.37209302325581395
train,patches_5.xml,200,200,patches,118,1,200,34,159.0,17.5,82,33,2.484848484848485
train,patches_50.xml,200,200,patches,61,2,106,58,83.5,30.0,45,56,0.8035714285714286
train,patches_50.xml,200,200,patches,80,125,119,178,99.5,151.5,39,53,0.7358490566037735
train,patches_51.xml,200,200,patches,60,59,124,139,92.0,99.0,64,80,0.8
train,patches_52.xml,200,200,patches,47,12,138,184,92.5,98.0,91,172,0.5290697674418605
train,patches_53.xml,200,200,patches,28,10,67,59,47.5,34.5,39,49,0.7959183673469388
train,patches_53.xml,200,200,patches,12,102,86,200,49.0,151.0,74,98,0.7551020408163265
train,patches_53.xml,200,200,patches,138,74,200,157,169.0,115.5,62,83,0.7469879518072289
train,patches_54.xml,200,200,patches,89,18,150,120,119.5,69.0,61,102,0.5980392156862745
train,patches_55.xml,200,200,patches,26,80,69,122,47.5,101.0,43,42,1.0238095238095237
train,patches_55.xml,200,200,patches,78,27,148,163,113.0,95.0,70,136,0.5147058823529411
train,patches_56.xml,200,200,patches,31,67,105,96,68.0,81.5,74,29,2.5517241379310347
train,patches_56.xml,200,200,patches,34,101,66,129,50.0,115.0,32,28,1.1428571428571428
train,patches_56.xml,200,200,patches,117,99,142,124,129.5,111.5,25,25,1.0
train,patches_56.xml,200,200,patches,160,82,200,144,180.0,113.0,40,62,0.6451612903225806
train,patches_57.xml,200,200,patches,87,15,129,148,108.0,81.5,42,133,0.3157894736842105
train,patches_57.xml,200,200,patches,82,154,132,200,107.0,177.0,50,46,1.0869565217391304
train,patches_58.xml,200,200,patches,22,14,60,110,41.0,62.0,38,96,0.3958333333333333
train,patches_58.xml,200,200,patches,69,26,109,84,89.0,55.0,40,58,0.6896551724137931
train,patches_58.xml,200,200,patches,30,136,70,200,50.0,168.0,40,64,0.625
train,patches_58.xml,200,200,patches,138,92,186,136,162.0,114.0,48,44,1.0909090909090908
train,patches_59.xml,200,200,patches,78,2,117,127,97.5,64.5,39,125,0.312
train,patches_59.xml,200,200,patches,69,142,123,200,96.0,171.0,54,58,0.9310344827586207
train,patches_6.xml,200,200,patches,13,6,90,200,51.5,103.0,77,194,0.39690721649484534
train,patches_6.xml,200,200,patches,84,33,197,160,140.5,96.5,113,127,0.889763779527559
train,patches_60.xml,200,200,patches,3,112,43,159,23.0,135.5,40,47,0.851063829787234
train,patches_60.xml,200,200,patches,162,151,199,199,180.5,175.0,37,48,0.7708333333333334
train,patches_60.xml,200,200,patches,143,50,191,147,167.0,98.5,48,97,0.4948453608247423
train,patches_60.xml,200,200,patches,146,1,190,43,168.0,22.0,44,42,1.0476190476190477
train,patches_61.xml,200,200,patches,76,1,124,63,100.0,32.0,48,62,0.7741935483870968
train,patches_62.xml,200,200,patches,89,34,122,126,105.5,80.0,33,92,0.358695652173913
train,patches_63.xml,200,200,patches,83,79,129,139,106.0,109.0,46,60,0.7666666666666667
train,patches_64.xml,200,200,patches,67,103,134,139,100.5,121.0,67,36,1.8611111111111112
train,patches_65.xml,200,200,patches,55,71,138,148,96.5,109.5,83,77,1.077922077922078
train,patches_66.xml,200,200,patches,35,14,72,69,53.5,41.5,37,55,0.6727272727272727
train,patches_66.xml,200,200,patches,99,75,160,148,129.5,111.5,61,73,0.8356164383561644
train,patches_67.xml,200,200,patches,15,75,81,147,48.0,111.0,66,72,0.9166666666666666
train,patches_67.xml,200,200,patches,143,35,179,108,161.0,71.5,36,73,0.4931506849315068
train,patches_67.xml,200,200,patches,163,163,194,200,178.5,181.5,31,37,0.8378378378378378
train,patches_68.xml,200,200,patches,21,32,58,110,39.5,71.0,37,78,0.47435897435897434
train,patches_68.xml,200,200,patches,160,13,199,67,179.5,40.0,39,54,0.7222222222222222
train,patches_68.xml,200,200,patches,37,163,70,200,53.5,181.5,33,37,0.8918918918918919
train,patches_69.xml,200,200,patches,39,145,87,200,63.0,172.5,48,55,0.8727272727272727
train,patches_69.xml,200,200,patches,109,147,155,200,132.0,173.5,46,53,0.8679245283018868
train,patches_7.xml,200,200,patches,32,12,123,198,77.5,105.0,91,186,0.489247311827957
train,patches_70.xml,200,200,patches,63,74,152,199,107.5,136.5,89,125,0.712
train,patches_71.xml,200,200,patches,1,1,37,51,19.0,26.0,36,50,0.72
train,patches_71.xml,200,200,patches,118,1,159,60,138.5,30.5,41,59,0.6949152542372882
train,patches_71.xml,200,200,patches,123,75,199,190,161.0,132.5,76,115,0.6608695652173913
train,patches_72.xml,200,200,patches,12,48,53,91,32.5,69.5,41,43,0.9534883720930233
train,patches_72.xml,200,200,patches,153,50,192,116,172.5,83.0,39,66,0.5909090909090909
train,patches_73.xml,200,200,patches,45,1,78,29,61.5,15.0,33,28,1.1785714285714286
train,patches_73.xml,200,200,patches,102,1,134,24,118.0,12.5,32,23,1.391304347826087
train,patches_73.xml,200,200,patches,107,138,153,177,130.0,157.5,46,39,1.1794871794871795
train,patches_74.xml,200,200,patches,3,117,43,200,23.0,158.5,40,83,0.4819277108433735
train,patches_74.xml,200,200,patches,122,2,199,158,160.5,80.0,77,156,0.4935897435897436
train,patches_75.xml,200,200,patches,55,100,95,169,75.0,134.5,40,69,0.5797101449275363
train,patches_75.xml,200,200,patches,107,24,158,110,132.5,67.0,51,86,0.5930232558139535
train,patches_76.xml,200,200,patches,70,33,123,154,96.5,93.5,53,121,0.4380165289256198
train,patches_76.xml,200,200,patches,35,1,111,21,73.0,11.0,76,20,3.8
train,patches_77.xml,200,200,patches,164,74,199,110,181.5,92.0,35,36,0.9722222222222222
train,patches_77.xml,200,200,patches,136,153,197,199,166.5,176.0,61,46,1.326086956521739
train,patches_77.xml,200,200,patches,23,1,52,32,37.5,16.5,29,31,0.9354838709677419
train,patches_78.xml,200,200,patches,9,36,47,178,28.0,107.0,38,142,0.2676056338028169
train,patches_78.xml,200,200,patches,146,119,185,179,165.5,149.0,39,60,0.65
train,patches_78.xml,200,200,patches,12,166,53,200,32.5,183.0,41,34,1.2058823529411764
train,patches_79.xml,200,200,patches,47,47,128,149,87.5,98.0,81,102,0.7941176470588235
train,patches_79.xml,200,200,patches,102,157,133,196,117.5,176.5,31,39,0.7948717948717948
train,patches_79.xml,200,200,patches,83,1,121,45,102.0,23.0,38,44,0.8636363636363636
train,patches_8.xml,200,200,patches,40,18,74,57,57.0,37.5,34,39,0.8717948717948718
train,patches_8.xml,200,200,patches,86,42,166,128,126.0,85.0,80,86,0.9302325581395349
train,patches_8.xml,200,200,patches,41,133,70,199,55.5,166.0,29,66,0.4393939393939394
train,patches_80.xml,200,200,patches,73,74,124,186,98.5,130.0,51,112,0.45535714285714285
train,patches_80.xml,200,200,patches,66,24,103,82,84.5,53.0,37,58,0.6379310344827587
train,patches_81.xml,200,200,patches,1,32,53,144,27.0,88.0,52,112,0.4642857142857143
train,patches_81.xml,200,200,patches,1,1,43,38,22.0,19.5,42,37,1.135135135135135
train,patches_81.xml,200,200,patches,134,1,182,51,158.0,26.0,48,50,0.96
train,patches_81.xml,200,200,patches,21,151,58,195,39.5,173.0,37,44,0.8409090909090909
train,patches_81.xml,200,200,patches,152,133,195,200,173.5,166.5,43,67,0.6417910447761194
train,patches_82.xml,200,200,patches,70,4,143,102,106.5,53.0,73,98,0.7448979591836735
train,patches_83.xml,200,200,patches,79,55,125,199,102.0,127.0,46,144,0.3194444444444444
train,patches_84.xml,200,200,patches,26,102,99,168,62.5,135.0,73,66,1.106060606060606
train,patches_84.xml,200,200,patches,113,72,169,189,141.0,130.5,56,117,0.47863247863247865
train,patches_84.xml,200,200,patches,114,1,159,80,136.5,40.5,45,79,0.569620253164557
train,patches_85.xml,200,200,patches,44,12,98,66,71.0,39.0,54,54,1.0
train,patches_85.xml,200,200,patches,107,1,156,79,131.5,40.0,49,78,0.6282051282051282
train,patches_86.xml,200,200,patches,40,37,145,150,92.5,93.5,105,113,0.9292035398230089
train,patches_87.xml,200,200,patches,9,7,93,67,51.0,37.0,84,60,1.4
train,patches_87.xml,200,200,patches,106,26,154,102,130.0,64.0,48,76,0.631578947368421
train,patches_87.xml,200,200,patches,114,139,198,199,156.0,169.0,84,60,1.4
train,patches_87.xml,200,200,patches,156,27,200,103,178.0,65.0,44,76,0.5789473684210527
train,patches_88.xml,200,200,patches,1,28,35,98,18.0,63.0,34,70,0.4857142857142857
train,patches_88.xml,200,200,patches,39,45,117,102,78.0,73.5,78,57,1.368421052631579
train,patches_88.xml,200,200,patches,123,15,172,138,147.5,76.5,49,123,0.3983739837398374
train,patches_88.xml,200,200,patches,1,138,87,200,44.0,169.0,86,62,1.3870967741935485
train,patches_89.xml,200,200,patches,1,1,19,36,10.0,18.5,18,35,0.5142857142857142
train,patches_89.xml,200,200,patches,29,5,70,70,49.5,37.5,41,65,0.6307692307692307
train,patches_89.xml,200,200,patches,78,8,146,72,112.0,40.0,68,64,1.0625
train,patches_89.xml,200,200,patches,156,1,198,115,177.0,58.0,42,114,0.3684210526315789
train,patches_89.xml,200,200,patches,35,113,125,200,80.0,156.5,90,87,1.0344827586206897
train,patches_89.xml,200,200,patches,173,172,200,200,186.5,186.0,27,28,0.9642857142857143
train,patches_9.xml,200,200,patches,65,66,139,138,102.0,102.0,74,72,1.0277777777777777
train,patches_90.xml,200,200,patches,69,7,162,200,115.5,103.5,93,193,0.48186528497409326
train,patches_90.xml,200,200,patches,130,120,182,200,156.0,160.0,52,80,0.65
train,patches_90.xml,200,200,patches,20,103,73,161,46.5,132.0,53,58,0.9137931034482759
train,patches_91.xml,200,200,patches,25,110,68,187,46.5,148.5,43,77,0.5584415584415584
train,patches_91.xml,200,200,patches,1,126,21,200,11.0,163.0,20,74,0.2702702702702703
train,patches_91.xml,200,200,patches,98,61,150,181,124.0,121.0,52,120,0.43333333333333335
train,patches_91.xml,200,200,patches,1,1,52,28,26.5,14.5,51,27,1.8888888888888888
train,patches_92.xml,200,200,patches,10,72,64,193,37.0,132.5,54,121,0.4462809917355372
train,patches_92.xml,200,200,patches,98,30,171,125,134.5,77.5,73,95,0.7684210526315789
train,patches_92.xml,200,200,patches,111,134,155,200,133.0,167.0,44,66,0.6666666666666666
train,patches_92.xml,200,200,patches,1,1,23,66,12.0,33.5,22,65,0.3384615384615385
train,patches_92.xml,200,200,patches,29,1,70,19,49.5,10.0,41,18,2.2777777777777777
train,patches_92.xml,200,200,patches,112,1,153,18,132.5,9.5,41,17,2.411764705882353
train,patches_93.xml,200,200,patches,10,1,76,128,43.0,64.5,66,127,0.5196850393700787
train,patches_93.xml,200,200,patches,81,9,127,82,104.0,45.5,46,73,0.6301369863013698
train,patches_93.xml,200,200,patches,69,136,120,200,94.5,168.0,51,64,0.796875
train,patches_93.xml,200,200,patches,157,101,200,200,178.5,150.5,43,99,0.43434343434343436
train,patches_93.xml,200,200,patches,163,1,200,83,181.5,42.0,37,82,0.45121951219512196
train,patches_94.xml,200,200,patches,85,73,120,127,102.5,100.0,35,54,0.6481481481481481
train,patches_95.xml,200,200,patches,89,73,170,170,129.5,121.5,81,97,0.8350515463917526
train,patches_95.xml,200,200,patches,43,74,94,145,68.5,109.5,51,71,0.7183098591549296
train,patches_95.xml,200,200,patches,174,97,200,158,187.0,127.5,26,61,0.4262295081967213
train,patches_96.xml,200,200,patches,67,51,143,165,105.0,108.0,76,114,0.6666666666666666
train,patches_97.xml,200,200,patches,75,51,133,145,104.0,98.0,58,94,0.6170212765957447
train,patches_97.xml,200,200,patches,90,146,130,193,110.0,169.5,40,47,0.851063829787234
train,patches_98.xml,200,200,patches,15,68,106,185,60.5,126.5,91,117,0.7777777777777778
train,patches_98.xml,200,200,patches,100,94,172,191,136.0,142.5,72,97,0.7422680412371134
train,patches_99.xml,200,200,patches,17,1,94,53,55.5,27.0,77,52,1.4807692307692308
train,patches_99.xml,200,200,patches,29,133,79,200,54.0,166.5,50,67,0.746268656716418
train,patches_99.xml,200,200,patches,110,45,165,199,137.5,122.0,55,154,0.35714285714285715
train,patches_99.xml,200,200,patches,105,1,156,58,130.5,29.5,51,57,0.8947368421052632
train,pitted_surface_1.xml,200,200,pitted_surface,21,2,188,196,104.5,99.0,167,194,0.8608247422680413
train,pitted_surface_10.xml,200,200,pitted_surface,5,56,195,194,100.0,125.0,190,138,1.3768115942028984
train,pitted_surface_100.xml,200,200,pitted_surface,2,2,50,194,26.0,98.0,48,192,0.25
train,pitted_surface_100.xml,200,200,pitted_surface,60,6,198,198,129.0,102.0,138,192,0.71875
train,pitted_surface_101.xml,200,200,pitted_surface,76,1,153,200,114.5,100.5,77,199,0.3869346733668342
train,pitted_surface_101.xml,200,200,pitted_surface,155,1,200,198,177.5,99.5,45,197,0.22842639593908629
train,pitted_surface_102.xml,200,200,pitted_surface,5,11,72,192,38.5,101.5,67,181,0.3701657458563536
train,pitted_surface_102.xml,200,200,pitted_surface,88,1,200,199,144.0,100.0,112,198,0.5656565656565656
train,pitted_surface_103.xml,200,200,pitted_surface,17,3,95,140,56.0,71.5,78,137,0.5693430656934306
train,pitted_surface_103.xml,200,200,pitted_surface,111,1,195,189,153.0,95.0,84,188,0.44680851063829785
train,pitted_surface_104.xml,200,200,pitted_surface,3,1,138,185,70.5,93.0,135,184,0.7336956521739131
train,pitted_surface_105.xml,200,200,pitted_surface,1,1,129,188,65.0,94.5,128,187,0.6844919786096256
train,pitted_surface_106.xml,200,200,pitted_surface,82,2,197,199,139.5,100.5,115,197,0.583756345177665
train,pitted_surface_107.xml,200,200,pitted_surface,26,2,188,200,107.0,101.0,162,198,0.8181818181818182
train,pitted_surface_108.xml,200,200,pitted_surface,48,55,170,199,109.0,127.0,122,144,0.8472222222222222
train,pitted_surface_109.xml,200,200,pitted_surface,25,2,143,199,84.0,100.5,118,197,0.5989847715736041
train,pitted_surface_109.xml,200,200,pitted_surface,152,1,195,199,173.5,100.0,43,198,0.21717171717171718
train,pitted_surface_11.xml,200,200,pitted_surface,2,37,178,197,90.0,117.0,176,160,1.1
train,pitted_surface_110.xml,200,200,pitted_surface,6,1,196,200,101.0,100.5,190,199,0.9547738693467337
train,pitted_surface_111.xml,200,200,pitted_surface,6,8,177,196,91.5,102.0,171,188,0.9095744680851063
train,pitted_surface_112.xml,200,200,pitted_surface,9,25,197,197,103.0,111.0,188,172,1.0930232558139534
train,pitted_surface_113.xml,200,200,pitted_surface,35,3,138,198,86.5,100.5,103,195,0.5282051282051282
train,pitted_surface_113.xml,200,200,pitted_surface,168,1,198,185,183.0,93.0,30,184,0.16304347826086957
train,pitted_surface_114.xml,200,200,pitted_surface,1,1,54,189,27.5,95.0,53,188,0.28191489361702127
train,pitted_surface_114.xml,200,200,pitted_surface,78,1,119,197,98.5,99.0,41,196,0.20918367346938777
train,pitted_surface_114.xml,200,200,pitted_surface,123,1,197,75,160.0,38.0,74,74,1.0
train,pitted_surface_115.xml,200,200,pitted_surface,1,1,200,199,100.5,100.0,199,198,1.005050505050505
train,pitted_surface_116.xml,200,200,pitted_surface,4,1,200,200,102.0,100.5,196,199,0.9849246231155779
train,pitted_surface_117.xml,200,200,pitted_surface,14,9,200,199,107.0,104.0,186,190,0.9789473684210527
train,pitted_surface_118.xml,200,200,pitted_surface,1,1,184,200,92.5,100.5,183,199,0.9195979899497487
train,pitted_surface_119.xml,200,200,pitted_surface,6,1,129,194,67.5,97.5,123,193,0.6373056994818653
train,pitted_surface_119.xml,200,200,pitted_surface,160,2,196,164,178.0,83.0,36,162,0.2222222222222222
train,pitted_surface_12.xml,200,200,pitted_surface,2,1,195,195,98.5,98.0,193,194,0.9948453608247423
train,pitted_surface_120.xml,200,200,pitted_surface,1,1,72,198,36.5,99.5,71,197,0.3604060913705584
train,pitted_surface_120.xml,200,200,pitted_surface,79,1,160,197,119.5,99.0,81,196,0.413265306122449
train,pitted_surface_121.xml,200,200,pitted_surface,16,4,95,195,55.5,99.5,79,191,0.41361256544502617
train,pitted_surface_121.xml,200,200,pitted_surface,121,1,200,197,160.5,99.0,79,196,0.4030612244897959
train,pitted_surface_122.xml,200,200,pitted_surface,19,1,169,174,94.0,87.5,150,173,0.8670520231213873
train,pitted_surface_122.xml,200,200,pitted_surface,173,23,200,199,186.5,111.0,27,176,0.1534090909090909
train,pitted_surface_123.xml,200,200,pitted_surface,67,1,189,195,128.0,98.0,122,194,0.6288659793814433
train,pitted_surface_124.xml,200,200,pitted_surface,1,1,103,135,52.0,68.0,102,134,0.7611940298507462
train,pitted_surface_124.xml,200,200,pitted_surface,117,1,195,54,156.0,27.5,78,53,1.471698113207547
train,pitted_surface_125.xml,200,200,pitted_surface,4,2,130,111,67.0,56.5,126,109,1.1559633027522935
train,pitted_surface_125.xml,200,200,pitted_surface,136,2,198,197,167.0,99.5,62,195,0.31794871794871793
train,pitted_surface_126.xml,200,200,pitted_surface,1,2,193,195,97.0,98.5,192,193,0.9948186528497409
train,pitted_surface_127.xml,200,200,pitted_surface,4,2,81,191,42.5,96.5,77,189,0.4074074074074074
train,pitted_surface_127.xml,200,200,pitted_surface,90,2,194,192,142.0,97.0,104,190,0.5473684210526316
train,pitted_surface_128.xml,200,200,pitted_surface,73,2,185,181,129.0,91.5,112,179,0.6256983240223464
train,pitted_surface_129.xml,200,200,pitted_surface,1,1,78,200,39.5,100.5,77,199,0.3869346733668342
train,pitted_surface_129.xml,200,200,pitted_surface,82,1,200,200,141.0,100.5,118,199,0.592964824120603
train,pitted_surface_13.xml,200,200,pitted_surface,1,2,70,198,35.5,100.0,69,196,0.3520408163265306
train,pitted_surface_13.xml,200,200,pitted_surface,153,3,200,177,176.5,90.0,47,174,0.27011494252873564
train,pitted_surface_130.xml,200,200,pitted_surface,24,38,147,195,85.5,116.5,123,157,0.7834394904458599
train,pitted_surface_130.xml,200,200,pitted_surface,171,1,199,198,185.0,99.5,28,197,0.14213197969543148
train,pitted_surface_131.xml,200,200,pitted_surface,62,21,177,188,119.5,104.5,115,167,0.688622754491018
train,pitted_surface_132.xml,200,200,pitted_surface,58,1,175,190,116.5,95.5,117,189,0.6190476190476191
train,pitted_surface_133.xml,200,200,pitted_surface,31,1,165,151,98.0,76.0,134,150,0.8933333333333333
train,pitted_surface_134.xml,200,200,pitted_surface,1,1,166,118,83.5,59.5,165,117,1.4102564102564104
train,pitted_surface_135.xml,200,200,pitted_surface,1,2,86,193,43.5,97.5,85,191,0.44502617801047123
train,pitted_surface_135.xml,200,200,pitted_surface,112,1,199,198,155.5,99.5,87,197,0.4416243654822335
train,pitted_surface_136.xml,200,200,pitted_surface,1,1,200,198,100.5,99.5,199,197,1.0101522842639594
train,pitted_surface_137.xml,200,200,pitted_surface,2,3,99,195,50.5,99.0,97,192,0.5052083333333334
train,pitted_surface_137.xml,200,200,pitted_surface,152,3,198,196,175.0,99.5,46,193,0.23834196891191708
train,pitted_surface_138.xml,200,200,pitted_surface,10,1,200,198,105.0,99.5,190,197,0.9644670050761421
train,pitted_surface_139.xml,200,200,pitted_surface,1,3,195,195,98.0,99.0,194,192,1.0104166666666667
train,pitted_surface_14.xml,200,200,pitted_surface,2,2,195,197,98.5,99.5,193,195,0.9897435897435898
train,pitted_surface_140.xml,200,200,pitted_surface,2,1,73,193,37.5,97.0,71,192,0.3697916666666667
train,pitted_surface_140.xml,200,200,pitted_surface,106,1,200,197,153.0,99.0,94,196,0.47959183673469385
train,pitted_surface_141.xml,200,200,pitted_surface,1,1,198,200,99.5,100.5,197,199,0.9899497487437185
train,pitted_surface_142.xml,200,200,pitted_surface,4,1,196,196,100.0,98.5,192,195,0.9846153846153847
train,pitted_surface_143.xml,200,200,pitted_surface,95,1,200,199,147.5,100.0,105,198,0.5303030303030303
train,pitted_surface_144.xml,200,200,pitted_surface,1,1,199,199,100.0,100.0,198,198,1.0
train,pitted_surface_145.xml,200,200,pitted_surface,1,1,199,197,100.0,99.0,198,196,1.010204081632653
train,pitted_surface_146.xml,200,200,pitted_surface,2,5,195,195,98.5,100.0,193,190,1.0157894736842106
train,pitted_surface_147.xml,200,200,pitted_surface,2,1,199,199,100.5,100.0,197,198,0.9949494949494949
train,pitted_surface_148.xml,200,200,pitted_surface,2,1,197,199,99.5,100.0,195,198,0.9848484848484849
train,pitted_surface_149.xml,200,200,pitted_surface,23,1,144,199,83.5,100.0,121,198,0.6111111111111112
train,pitted_surface_149.xml,200,200,pitted_surface,159,49,198,198,178.5,123.5,39,149,0.26174496644295303
train,pitted_surface_15.xml,200,200,pitted_surface,1,1,198,199,99.5,100.0,197,198,0.9949494949494949
train,pitted_surface_150.xml,200,200,pitted_surface,1,1,35,152,18.0,76.5,34,151,0.2251655629139073
train,pitted_surface_150.xml,200,200,pitted_surface,42,20,198,198,120.0,109.0,156,178,0.8764044943820225
train,pitted_surface_151.xml,200,200,pitted_surface,1,2,194,197,97.5,99.5,193,195,0.9897435897435898
train,pitted_surface_152.xml,200,200,pitted_surface,4,2,192,196,98.0,99.0,188,194,0.9690721649484536
train,pitted_surface_153.xml,200,200,pitted_surface,16,1,134,158,75.0,79.5,118,157,0.7515923566878981
train,pitted_surface_154.xml,200,200,pitted_surface,3,1,83,195,43.0,98.0,80,194,0.41237113402061853
train,pitted_surface_154.xml,200,200,pitted_surface,134,3,200,178,167.0,90.5,66,175,0.37714285714285717
train,pitted_surface_155.xml,200,200,pitted_surface,10,7,196,196,103.0,101.5,186,189,0.9841269841269841
train,pitted_surface_155.xml,200,200,patches,1,1,28,61,14.5,31.0,27,60,0.45
train,pitted_surface_155.xml,200,200,patches,78,1,108,20,93.0,10.5,30,19,1.5789473684210527
train,pitted_surface_156.xml,200,200,pitted_surface,28,2,144,196,86.0,99.0,116,194,0.5979381443298969
train,pitted_surface_156.xml,200,200,patches,1,78,36,113,18.5,95.5,35,35,1.0
train,pitted_surface_157.xml,200,200,pitted_surface,11,2,196,195,103.5,98.5,185,193,0.9585492227979274
train,pitted_surface_158.xml,200,200,pitted_surface,12,8,198,198,105.0,103.0,186,190,0.9789473684210527
train,pitted_surface_159.xml,200,200,pitted_surface,14,9,188,198,101.0,103.5,174,189,0.9206349206349206
train,pitted_surface_159.xml,200,200,patches,174,1,200,48,187.0,24.5,26,47,0.5531914893617021
train,pitted_surface_16.xml,200,200,pitted_surface,1,1,199,198,100.0,99.5,198,197,1.0050761421319796
train,pitted_surface_160.xml,200,200,pitted_surface,2,10,196,198,99.0,104.0,194,188,1.0319148936170213
train,pitted_surface_160.xml,200,200,patches,153,1,198,68,175.5,34.5,45,67,0.6716417910447762
train,pitted_surface_161.xml,200,200,pitted_surface,1,11,164,198,82.5,104.5,163,187,0.8716577540106952
train,pitted_surface_161.xml,200,200,patches,92,1,197,197,144.5,99.0,105,196,0.5357142857142857
train,pitted_surface_162.xml,200,200,pitted_surface,4,9,195,191,99.5,100.0,191,182,1.0494505494505495
train,pitted_surface_162.xml,200,200,patches,159,1,200,48,179.5,24.5,41,47,0.8723404255319149
train,pitted_surface_163.xml,200,200,pitted_surface,12,4,74,199,43.0,101.5,62,195,0.31794871794871793
train,pitted_surface_163.xml,200,200,pitted_surface,78,1,200,200,139.0,100.5,122,199,0.6130653266331658
train,pitted_surface_164.xml,200,200,pitted_surface,1,1,196,200,98.5,100.5,195,199,0.9798994974874372
train,pitted_surface_165.xml,200,200,pitted_surface,1,1,159,198,80.0,99.5,158,197,0.8020304568527918
train,pitted_surface_165.xml,200,200,patches,155,21,195,187,175.0,104.0,40,166,0.24096385542168675
train,pitted_surface_166.xml,200,200,pitted_surface,1,1,93,198,47.0,99.5,92,197,0.467005076142132
train,pitted_surface_166.xml,200,200,pitted_surface,114,36,199,161,156.5,98.5,85,125,0.68
train,pitted_surface_166.xml,200,200,patches,96,1,123,127,109.5,64.0,27,126,0.21428571428571427
train,pitted_surface_167.xml,200,200,pitted_surface,1,2,188,192,94.5,97.0,187,190,0.9842105263157894
train,pitted_surface_168.xml,200,200,pitted_surface,27,1,101,115,64.0,58.0,74,114,0.6491228070175439
train,pitted_surface_168.xml,200,200,pitted_surface,103,1,199,194,151.0,97.5,96,193,0.49740932642487046
train,pitted_surface_169.xml,200,200,pitted_surface,1,1,200,198,100.5,99.5,199,197,1.0101522842639594
train,pitted_surface_17.xml,200,200,pitted_surface,1,1,199,199,100.0,100.0,198,198,1.0
train,pitted_surface_170.xml,200,200,pitted_surface,1,1,200,182,100.5,91.5,199,181,1.0994475138121547
train,pitted_surface_170.xml,200,200,patches,99,74,146,143,122.5,108.5,47,69,0.6811594202898551
train,pitted_surface_170.xml,200,200,patches,142,162,172,199,157.0,180.5,30,37,0.8108108108108109
train,pitted_surface_171.xml,200,200,pitted_surface,20,1,200,189,110.0,95.0,180,188,0.9574468085106383
train,pitted_surface_171.xml,200,200,patches,26,136,70,198,48.0,167.0,44,62,0.7096774193548387
train,pitted_surface_171.xml,200,200,patches,2,50,41,116,21.5,83.0,39,66,0.5909090909090909
train,pitted_surface_172.xml,200,200,pitted_surface,74,1,199,174,136.5,87.5,125,173,0.7225433526011561
train,pitted_surface_172.xml,200,200,patches,20,166,72,200,46.0,183.0,52,34,1.5294117647058822
train,pitted_surface_172.xml,200,200,patches,155,157,200,200,177.5,178.5,45,43,1.0465116279069768
train,pitted_surface_173.xml,200,200,pitted_surface,4,1,200,182,102.0,91.5,196,181,1.0828729281767955
train,pitted_surface_173.xml,200,200,patches,98,176,147,199,122.5,187.5,49,23,2.130434782608696
train,pitted_surface_173.xml,200,200,patches,152,155,196,200,174.0,177.5,44,45,0.9777777777777777
train,pitted_surface_174.xml,200,200,pitted_surface,1,1,184,153,92.5,77.0,183,152,1.2039473684210527
train,pitted_surface_174.xml,200,200,patches,174,46,200,115,187.0,80.5,26,69,0.37681159420289856
train,pitted_surface_174.xml,200,200,patches,37,173,95,200,66.0,186.5,58,27,2.1481481481481484
train,pitted_surface_174.xml,200,200,patches,102,149,153,200,127.5,174.5,51,51,1.0
train,pitted_surface_175.xml,200,200,pitted_surface,1,1,125,198,63.0,99.5,124,197,0.6294416243654822
train,pitted_surface_175.xml,200,200,pitted_surface,132,1,200,195,166.0,98.0,68,194,0.35051546391752575
train,pitted_surface_175.xml,200,200,patches,122,152,163,200,142.5,176.0,41,48,0.8541666666666666
train,pitted_surface_176.xml,200,200,pitted_surface,19,1,199,194,109.0,97.5,180,193,0.9326424870466321
train,pitted_surface_177.xml,200,200,pitted_surface,1,13,198,190,99.5,101.5,197,177,1.112994350282486
train,pitted_surface_178.xml,200,200,pitted_surface,1,19,56,197,28.5,108.0,55,178,0.3089887640449438
train,pitted_surface_178.xml,200,200,pitted_surface,66,29,157,180,111.5,104.5,91,151,0.6026490066225165
train,pitted_surface_179.xml,200,200,pitted_surface,5,7,197,199,101.0,103.0,192,192,1.0
train,pitted_surface_18.xml,200,200,pitted_surface,63,1,199,200,131.0,100.5,136,199,0.6834170854271356
train,pitted_surface_180.xml,200,200,pitted_surface,1,1,199,199,100.0,100.0,198,198,1.0
train,pitted_surface_181.xml,200,200,pitted_surface,15,1,197,196,106.0,98.5,182,195,0.9333333333333333
train,pitted_surface_182.xml,200,200,pitted_surface,23,1,199,200,111.0,100.5,176,199,0.8844221105527639
train,pitted_surface_183.xml,200,200,pitted_surface,3,2,145,191,74.0,96.5,142,189,0.7513227513227513
train,pitted_surface_184.xml,200,200,pitted_surface,1,1,196,195,98.5,98.0,195,194,1.0051546391752577
train,pitted_surface_185.xml,200,200,pitted_surface,5,1,200,197,102.5,99.0,195,196,0.9948979591836735
train,pitted_surface_186.xml,200,200,pitted_surface,1,7,126,199,63.5,103.0,125,192,0.6510416666666666
train,pitted_surface_187.xml,200,200,pitted_surface,72,4,177,196,124.5,100.0,105,192,0.546875
train,pitted_surface_188.xml,200,200,pitted_surface,57,1,199,199,128.0,100.0,142,198,0.7171717171717171
train,pitted_surface_189.xml,200,200,pitted_surface,3,6,155,195,79.0,100.5,152,189,0.8042328042328042
train,pitted_surface_19.xml,200,200,pitted_surface,9,1,61,197,35.0,99.0,52,196,0.2653061224489796
train,pitted_surface_19.xml,200,200,pitted_surface,77,1,199,200,138.0,100.5,122,199,0.6130653266331658
train,pitted_surface_190.xml,200,200,pitted_surface,6,2,197,183,101.5,92.5,191,181,1.0552486187845305
train,pitted_surface_191.xml,200,200,pitted_surface,1,1,199,103,100.0,52.0,198,102,1.9411764705882353
train,pitted_surface_192.xml,200,200,pitted_surface,8,13,195,197,101.5,105.0,187,184,1.016304347826087
train,pitted_surface_193.xml,200,200,pitted_surface,3,4,197,197,100.0,100.5,194,193,1.005181347150259
train,pitted_surface_194.xml,200,200,pitted_surface,45,12,162,195,103.5,103.5,117,183,0.639344262295082
train,pitted_surface_195.xml,200,200,pitted_surface,14,57,77,193,45.5,125.0,63,136,0.4632352941176471
train,pitted_surface_195.xml,200,200,pitted_surface,101,60,147,199,124.0,129.5,46,139,0.33093525179856115
train,pitted_surface_196.xml,200,200,pitted_surface,30,1,199,116,114.5,58.5,169,115,1.4695652173913043
train,pitted_surface_197.xml,200,200,pitted_surface,48,3,103,198,75.5,100.5,55,195,0.28205128205128205
train,pitted_surface_197.xml,200,200,pitted_surface,114,113,199,200,156.5,156.5,85,87,0.9770114942528736
train,pitted_surface_197.xml,200,200,inclusion,176,92,200,116,188.0,104.0,24,24,1.0
train,pitted_surface_198.xml,200,200,pitted_surface,18,25,144,162,81.0,93.5,126,137,0.9197080291970803
train,pitted_surface_199.xml,200,200,pitted_surface,30,5,159,192,94.5,98.5,129,187,0.6898395721925134
train,pitted_surface_2.xml,200,200,pitted_surface,24,1,83,175,53.5,88.0,59,174,0.3390804597701149
train,pitted_surface_2.xml,200,200,pitted_surface,86,1,200,199,143.0,100.0,114,198,0.5757575757575758
train,pitted_surface_20.xml,200,200,pitted_surface,8,1,91,179,49.5,90.0,83,178,0.46629213483146065
train,pitted_surface_20.xml,200,200,pitted_surface,97,1,199,200,148.0,100.5,102,199,0.5125628140703518
train,pitted_surface_200.xml,200,200,pitted_surface,16,3,177,194,96.5,98.5,161,191,0.8429319371727748
train,pitted_surface_201.xml,200,200,pitted_surface,87,3,200,197,143.5,100.0,113,194,0.5824742268041238
train,pitted_surface_202.xml,200,200,pitted_surface,9,4,200,197,104.5,100.5,191,193,0.9896373056994818
train,pitted_surface_203.xml,200,200,pitted_surface,4,8,195,190,99.5,99.0,191,182,1.0494505494505495
train,pitted_surface_204.xml,200,200,pitted_surface,1,1,195,192,98.0,96.5,194,191,1.0157068062827226
train,pitted_surface_205.xml,200,200,pitted_surface,1,1,179,198,90.0,99.5,178,197,0.9035532994923858
train,pitted_surface_205.xml,200,200,patches,179,129,200,193,189.5,161.0,21,64,0.328125
train,pitted_surface_206.xml,200,200,pitted_surface,45,1,199,199,122.0,100.0,154,198,0.7777777777777778
train,pitted_surface_207.xml,200,200,pitted_surface,1,12,155,200,78.0,106.0,154,188,0.8191489361702128
train,pitted_surface_207.xml,200,200,patches,161,8,199,87,180.0,47.5,38,79,0.4810126582278481
train,pitted_surface_207.xml,200,200,patches,134,136,200,200,167.0,168.0,66,64,1.03125
train,pitted_surface_208.xml,200,200,pitted_surface,1,1,163,150,82.0,75.5,162,149,1.087248322147651
train,pitted_surface_208.xml,200,200,patches,75,138,147,200,111.0,169.0,72,62,1.1612903225806452
train,pitted_surface_208.xml,200,200,patches,149,75,200,199,174.5,137.0,51,124,0.4112903225806452
train,pitted_surface_209.xml,200,200,pitted_surface,45,30,196,196,120.5,113.0,151,166,0.9096385542168675
train,pitted_surface_209.xml,200,200,patches,173,4,200,38,186.5,21.0,27,34,0.7941176470588235
train,pitted_surface_21.xml,200,200,pitted_surface,2,2,198,197,100.0,99.5,196,195,1.005128205128205
train,pitted_surface_210.xml,200,200,pitted_surface,3,18,168,164,85.5,91.0,165,146,1.13013698630137
train,pitted_surface_210.xml,200,200,patches,107,1,157,17,132.0,9.0,50,16,3.125
train,pitted_surface_210.xml,200,200,patches,179,1,200,42,189.5,21.5,21,41,0.5121951219512195
train,pitted_surface_210.xml,200,200,patches,170,102,200,164,185.0,133.0,30,62,0.4838709677419355
train,pitted_surface_210.xml,200,200,patches,114,143,176,200,145.0,171.5,62,57,1.087719298245614
train,pitted_surface_211.xml,200,200,pitted_surface,75,1,199,171,137.0,86.0,124,170,0.7294117647058823
train,pitted_surface_212.xml,200,200,pitted_surface,4,1,191,195,97.5,98.0,187,194,0.9639175257731959
train,pitted_surface_213.xml,200,200,pitted_surface,1,1,185,199,93.0,100.0,184,198,0.9292929292929293
train,pitted_surface_214.xml,200,200,pitted_surface,2,1,163,200,82.5,100.5,161,199,0.8090452261306532
train,pitted_surface_214.xml,200,200,patches,145,89,200,199,172.5,144.0,55,110,0.5
train,pitted_surface_214.xml,200,200,patches,173,40,197,111,185.0,75.5,24,71,0.3380281690140845
train,pitted_surface_215.xml,200,200,pitted_surface,2,7,198,199,100.0,103.0,196,192,1.0208333333333333
train,pitted_surface_216.xml,200,200,pitted_surface,30,74,200,200,115.0,137.0,170,126,1.3492063492063493
train,pitted_surface_217.xml,200,200,pitted_surface,16,22,138,191,77.0,106.5,122,169,0.7218934911242604
train,pitted_surface_217.xml,200,200,pitted_surface,155,66,198,200,176.5,133.0,43,134,0.3208955223880597
train,pitted_surface_218.xml,200,200,pitted_surface,1,10,197,200,99.0,105.0,196,190,1.0315789473684212
train,pitted_surface_219.xml,200,200,pitted_surface,1,16,154,198,77.5,107.0,153,182,0.8406593406593407
train,pitted_surface_22.xml,200,200,pitted_surface,1,1,198,198,99.5,99.5,197,197,1.0
train,pitted_surface_220.xml,200,200,pitted_surface,55,1,198,200,126.5,100.5,143,199,0.7185929648241206
train,pitted_surface_221.xml,200,200,pitted_surface,24,2,194,192,109.0,97.0,170,190,0.8947368421052632
train,pitted_surface_222.xml,200,200,pitted_surface,5,3,172,200,88.5,101.5,167,197,0.8477157360406091
train,pitted_surface_223.xml,200,200,pitted_surface,20,1,185,200,102.5,100.5,165,199,0.8291457286432161
train,pitted_surface_223.xml,200,200,patches,1,137,37,198,19.0,167.5,36,61,0.5901639344262295
train,pitted_surface_223.xml,200,200,patches,131,172,169,200,150.0,186.0,38,28,1.3571428571428572
train,pitted_surface_224.xml,200,200,pitted_surface,1,3,177,200,89.0,101.5,176,197,0.8934010152284264
train,pitted_surface_225.xml,200,200,pitted_surface,51,4,196,198,123.5,101.0,145,194,0.7474226804123711
train,pitted_surface_226.xml,200,200,pitted_surface,2,7,189,197,95.5,102.0,187,190,0.9842105263157894
train,pitted_surface_226.xml,200,200,patches,4,1,43,56,23.5,28.5,39,55,0.7090909090909091
train,pitted_surface_227.xml,200,200,pitted_surface,34,48,199,198,116.5,123.0,165,150,1.1
train,pitted_surface_228.xml,200,200,pitted_surface,11,16,199,199,105.0,107.5,188,183,1.0273224043715847
train,pitted_surface_229.xml,200,200,pitted_surface,1,4,199,199,100.0,101.5,198,195,1.0153846153846153
train,pitted_surface_23.xml,200,200,pitted_surface,1,1,200,198,100.5,99.5,199,197,1.0101522842639594
train,pitted_surface_230.xml,200,200,pitted_surface,5,5,194,192,99.5,98.5,189,187,1.0106951871657754
train,pitted_surface_231.xml,200,200,pitted_surface,1,1,184,200,92.5,100.5,183,199,0.9195979899497487
train,pitted_surface_232.xml,200,200,pitted_surface,118,8,193,200,155.5,104.0,75,192,0.390625
train,pitted_surface_233.xml,200,200,pitted_surface,67,7,142,183,104.5,95.0,75,176,0.42613636363636365
train,pitted_surface_233.xml,200,200,pitted_surface,162,76,198,147,180.0,111.5,36,71,0.5070422535211268
train,pitted_surface_234.xml,200,200,pitted_surface,21,6,95,147,58.0,76.5,74,141,0.524822695035461
train,pitted_surface_235.xml,200,200,pitted_surface,14,4,136,190,75.0,97.0,122,186,0.6559139784946236
train,pitted_surface_236.xml,200,200,pitted_surface,31,2,196,199,113.5,100.5,165,197,0.8375634517766497
train,pitted_surface_237.xml,200,200,pitted_surface,22,25,191,197,106.5,111.0,169,172,0.9825581395348837
train,pitted_surface_237.xml,200,200,patches,8,2,40,27,24.0,14.5,32,25,1.28
train,pitted_surface_238.xml,200,200,pitted_surface,1,15,185,199,93.0,107.0,184,184,1.0
train,pitted_surface_239.xml,200,200,pitted_surface,2,10,184,200,93.0,105.0,182,190,0.9578947368421052
train,pitted_surface_24.xml,200,200,pitted_surface,1,1,200,199,100.5,100.0,199,198,1.005050505050505
train,pitted_surface_240.xml,200,200,pitted_surface,11,1,194,183,102.5,92.0,183,182,1.0054945054945055
train,pitted_surface_25.xml,200,200,pitted_surface,1,1,199,198,100.0,99.5,198,197,1.0050761421319796
train,pitted_surface_26.xml,200,200,pitted_surface,35,1,200,200,117.5,100.5,165,199,0.8291457286432161
train,pitted_surface_27.xml,200,200,pitted_surface,37,1,200,198,118.5,99.5,163,197,0.8274111675126904
train,pitted_surface_28.xml,200,200,pitted_surface,1,1,199,199,100.0,100.0,198,198,1.0
train,pitted_surface_29.xml,200,200,pitted_surface,1,1,197,198,99.0,99.5,196,197,0.9949238578680203
train,pitted_surface_3.xml,200,200,pitted_surface,1,1,198,198,99.5,99.5,197,197,1.0
train,pitted_surface_30.xml,200,200,pitted_surface,1,1,199,199,100.0,100.0,198,198,1.0
train,pitted_surface_31.xml,200,200,pitted_surface,1,1,200,199,100.5,100.0,199,198,1.005050505050505
train,pitted_surface_32.xml,200,200,pitted_surface,1,1,200,199,100.5,100.0,199,198,1.005050505050505
train,pitted_surface_33.xml,200,200,pitted_surface,9,1,199,199,104.0,100.0,190,198,0.9595959595959596
train,pitted_surface_34.xml,200,200,pitted_surface,3,1,85,197,44.0,99.0,82,196,0.41836734693877553
train,pitted_surface_34.xml,200,200,pitted_surface,93,1,200,197,146.5,99.0,107,196,0.5459183673469388
train,pitted_surface_35.xml,200,200,pitted_surface,1,1,200,197,100.5,99.0,199,196,1.0153061224489797
train,pitted_surface_36.xml,200,200,pitted_surface,1,1,200,198,100.5,99.5,199,197,1.0101522842639594
train,pitted_surface_37.xml,200,200,pitted_surface,1,1,200,199,100.5,100.0,199,198,1.005050505050505
train,pitted_surface_38.xml,200,200,pitted_surface,1,1,200,199,100.5,100.0,199,198,1.005050505050505
train,pitted_surface_39.xml,200,200,pitted_surface,1,1,200,200,100.5,100.5,199,199,1.0
train,pitted_surface_4.xml,200,200,pitted_surface,19,2,150,199,84.5,100.5,131,197,0.6649746192893401
train,pitted_surface_40.xml,200,200,pitted_surface,3,1,200,198,101.5,99.5,197,197,1.0
train,pitted_surface_41.xml,200,200,pitted_surface,2,1,68,199,35.0,100.0,66,198,0.3333333333333333
train,pitted_surface_41.xml,200,200,pitted_surface,77,1,200,199,138.5,100.0,123,198,0.6212121212121212
train,pitted_surface_42.xml,200,200,pitted_surface,1,1,200,196,100.5,98.5,199,195,1.0205128205128204
train,pitted_surface_43.xml,200,200,pitted_surface,1,1,197,183,99.0,92.0,196,182,1.0769230769230769
train,pitted_surface_44.xml,200,200,pitted_surface,3,1,198,116,100.5,58.5,195,115,1.6956521739130435
train,pitted_surface_45.xml,200,200,pitted_surface,1,1,197,140,99.0,70.5,196,139,1.410071942446043
train,pitted_surface_46.xml,200,200,pitted_surface,1,1,51,199,26.0,100.0,50,198,0.25252525252525254
train,pitted_surface_46.xml,200,200,pitted_surface,69,1,200,196,134.5,98.5,131,195,0.6717948717948717
train,pitted_surface_47.xml,200,200,pitted_surface,5,1,88,199,46.5,100.0,83,198,0.41919191919191917
train,pitted_surface_47.xml,200,200,pitted_surface,118,1,199,200,158.5,100.5,81,199,0.40703517587939697
train,pitted_surface_48.xml,200,200,pitted_surface,2,1,196,197,99.0,99.0,194,196,0.9897959183673469
train,pitted_surface_49.xml,200,200,pitted_surface,1,1,197,198,99.0,99.5,196,197,0.9949238578680203
train,pitted_surface_5.xml,200,200,pitted_surface,1,1,193,196,97.0,98.5,192,195,0.9846153846153847
train,pitted_surface_50.xml,200,200,pitted_surface,9,1,111,200,60.0,100.5,102,199,0.5125628140703518
train,pitted_surface_50.xml,200,200,pitted_surface,117,1,200,200,158.5,100.5,83,199,0.41708542713567837
train,pitted_surface_51.xml,200,200,pitted_surface,1,1,197,200,99.0,100.5,196,199,0.9849246231155779
train,pitted_surface_52.xml,200,200,pitted_surface,1,1,199,200,100.0,100.5,198,199,0.9949748743718593
train,pitted_surface_53.xml,200,200,pitted_surface,1,1,200,198,100.5,99.5,199,197,1.0101522842639594
train,pitted_surface_54.xml,200,200,pitted_surface,3,1,197,194,100.0,97.5,194,193,1.005181347150259
train,pitted_surface_55.xml,200,200,pitted_surface,22,1,199,199,110.5,100.0,177,198,0.8939393939393939
train,pitted_surface_56.xml,200,200,pitted_surface,1,1,73,200,37.0,100.5,72,199,0.36180904522613067
train,pitted_surface_56.xml,200,200,pitted_surface,87,1,199,200,143.0,100.5,112,199,0.5628140703517588
train,pitted_surface_57.xml,200,200,pitted_surface,1,1,200,200,100.5,100.5,199,199,1.0
train,pitted_surface_58.xml,200,200,pitted_surface,1,1,200,198,100.5,99.5,199,197,1.0101522842639594
train,pitted_surface_59.xml,200,200,pitted_surface,6,1,200,199,103.0,100.0,194,198,0.9797979797979798
train,pitted_surface_6.xml,200,200,pitted_surface,1,1,197,197,99.0,99.0,196,196,1.0
train,pitted_surface_60.xml,200,200,pitted_surface,1,1,200,198,100.5,99.5,199,197,1.0101522842639594
train,pitted_surface_61.xml,200,200,pitted_surface,1,1,199,200,100.0,100.5,198,199,0.9949748743718593
train,pitted_surface_62.xml,200,200,pitted_surface,77,2,200,200,138.5,101.0,123,198,0.6212121212121212
train,pitted_surface_63.xml,200,200,pitted_surface,1,1,198,198,99.5,99.5,197,197,1.0
train,pitted_surface_64.xml,200,200,pitted_surface,1,1,200,198,100.5,99.5,199,197,1.0101522842639594
train,pitted_surface_65.xml,200,200,pitted_surface,5,1,199,195,102.0,98.0,194,194,1.0
train,pitted_surface_66.xml,200,200,pitted_surface,8,1,200,196,104.0,98.5,192,195,0.9846153846153847
train,pitted_surface_67.xml,200,200,pitted_surface,35,2,138,200,86.5,101.0,103,198,0.5202020202020202
train,pitted_surface_67.xml,200,200,pitted_surface,141,1,200,200,170.5,100.5,59,199,0.2964824120603015
train,pitted_surface_68.xml,200,200,pitted_surface,2,3,198,128,100.0,65.5,196,125,1.568
train,pitted_surface_69.xml,200,200,pitted_surface,13,1,104,133,58.5,67.0,91,132,0.6893939393939394
train,pitted_surface_69.xml,200,200,pitted_surface,137,1,200,200,168.5,100.5,63,199,0.3165829145728643
train,pitted_surface_7.xml,200,200,pitted_surface,1,1,200,198,100.5,99.5,199,197,1.0101522842639594
train,pitted_surface_70.xml,200,200,pitted_surface,1,1,200,200,100.5,100.5,199,199,1.0
train,pitted_surface_71.xml,200,200,pitted_surface,1,30,198,198,99.5,114.0,197,168,1.1726190476190477
train,pitted_surface_72.xml,200,200,pitted_surface,4,1,200,200,102.0,100.5,196,199,0.9849246231155779
train,pitted_surface_73.xml,200,200,pitted_surface,1,1,199,199,100.0,100.0,198,198,1.0
train,pitted_surface_74.xml,200,200,pitted_surface,1,1,200,198,100.5,99.5,199,197,1.0101522842639594
train,pitted_surface_75.xml,200,200,pitted_surface,12,1,57,192,34.5,96.5,45,191,0.2356020942408377
train,pitted_surface_75.xml,200,200,pitted_surface,87,1,200,200,143.5,100.5,113,199,0.5678391959798995
train,pitted_surface_76.xml,200,200,pitted_surface,1,1,200,199,100.5,100.0,199,198,1.005050505050505
train,pitted_surface_77.xml,200,200,pitted_surface,1,1,199,200,100.0,100.5,198,199,0.9949748743718593
train,pitted_surface_78.xml,200,200,pitted_surface,1,1,67,198,34.0,99.5,66,197,0.3350253807106599
train,pitted_surface_78.xml,200,200,pitted_surface,96,1,199,200,147.5,100.5,103,199,0.5175879396984925
train,pitted_surface_79.xml,200,200,pitted_surface,1,1,200,200,100.5,100.5,199,199,1.0
train,pitted_surface_8.xml,200,200,pitted_surface,1,1,199,199,100.0,100.0,198,198,1.0
train,pitted_surface_80.xml,200,200,pitted_surface,1,1,127,200,64.0,100.5,126,199,0.6331658291457286
train,pitted_surface_80.xml,200,200,pitted_surface,128,1,200,200,164.0,100.5,72,199,0.36180904522613067
train,pitted_surface_81.xml,200,200,pitted_surface,46,1,200,200,123.0,100.5,154,199,0.7738693467336684
train,pitted_surface_82.xml,200,200,pitted_surface,1,1,122,174,61.5,87.5,121,173,0.6994219653179191
train,pitted_surface_82.xml,200,200,pitted_surface,124,1,194,200,159.0,100.5,70,199,0.35175879396984927
train,pitted_surface_83.xml,200,200,pitted_surface,2,1,95,199,48.5,100.0,93,198,0.4696969696969697
train,pitted_surface_83.xml,200,200,pitted_surface,102,1,199,200,150.5,100.5,97,199,0.48743718592964824
train,pitted_surface_84.xml,200,200,pitted_surface,7,1,200,200,103.5,100.5,193,199,0.9698492462311558
train,pitted_surface_85.xml,200,200,pitted_surface,1,1,199,199,100.0,100.0,198,198,1.0
train,pitted_surface_86.xml,200,200,pitted_surface,13,1,200,200,106.5,100.5,187,199,0.9396984924623115
train,pitted_surface_87.xml,200,200,pitted_surface,1,1,56,198,28.5,99.5,55,197,0.27918781725888325
train,pitted_surface_87.xml,200,200,pitted_surface,63,1,193,135,128.0,68.0,130,134,0.9701492537313433
train,pitted_surface_88.xml,200,200,pitted_surface,1,1,200,200,100.5,100.5,199,199,1.0
train,pitted_surface_89.xml,200,200,pitted_surface,14,6,168,199,91.0,102.5,154,193,0.7979274611398963
train,pitted_surface_9.xml,200,200,pitted_surface,1,57,200,200,100.5,128.5,199,143,1.3916083916083917
train,pitted_surface_90.xml,200,200,pitted_surface,10,1,138,200,74.0,100.5,128,199,0.6432160804020101
train,pitted_surface_91.xml,200,200,pitted_surface,56,1,185,198,120.5,99.5,129,197,0.6548223350253807
train,pitted_surface_92.xml,200,200,pitted_surface,1,1,145,191,73.0,96.0,144,190,0.7578947368421053
train,pitted_surface_93.xml,200,200,pitted_surface,7,1,106,200,56.5,100.5,99,199,0.49748743718592964
train,pitted_surface_93.xml,200,200,pitted_surface,117,2,199,198,158.0,100.0,82,196,0.41836734693877553
train,pitted_surface_94.xml,200,200,pitted_surface,25,1,196,180,110.5,90.5,171,179,0.9553072625698324
train,pitted_surface_95.xml,200,200,pitted_surface,1,1,199,199,100.0,100.0,198,198,1.0
train,pitted_surface_96.xml,200,200,pitted_surface,1,1,195,199,98.0,100.0,194,198,0.9797979797979798
train,pitted_surface_97.xml,200,200,pitted_surface,1,1,200,199,100.5,100.0,199,198,1.005050505050505
train,pitted_surface_98.xml,200,200,pitted_surface,3,1,199,200,101.0,100.5,196,199,0.9849246231155779
train,pitted_surface_99.xml,200,200,pitted_surface,1,1,200,200,100.5,100.5,199,199,1.0
train,rolled-in_scale_1.xml,200,200,rolled-in_scale,63,38,139,169,101.0,103.5,76,131,0.5801526717557252
train,rolled-in_scale_10.xml,200,200,rolled-in_scale,54,39,144,139,99.0,89.0,90,100,0.9
train,rolled-in_scale_100.xml,200,200,rolled-in_scale,13,15,117,154,65.0,84.5,104,139,0.7482014388489209
train,rolled-in_scale_101.xml,200,200,rolled-in_scale,100,3,175,119,137.5,61.0,75,116,0.646551724137931
train,rolled-in_scale_102.xml,200,200,rolled-in_scale,66,21,178,199,122.0,110.0,112,178,0.6292134831460674
train,rolled-in_scale_103.xml,200,200,rolled-in_scale,93,75,200,176,146.5,125.5,107,101,1.0594059405940595
train,rolled-in_scale_104.xml,200,200,rolled-in_scale,49,18,154,159,101.5,88.5,105,141,0.7446808510638298
train,rolled-in_scale_105.xml,200,200,rolled-in_scale,1,21,103,162,52.0,91.5,102,141,0.723404255319149
train,rolled-in_scale_106.xml,200,200,rolled-in_scale,47,22,173,184,110.0,103.0,126,162,0.7777777777777778
train,rolled-in_scale_107.xml,200,200,rolled-in_scale,73,133,115,200,94.0,166.5,42,67,0.6268656716417911
train,rolled-in_scale_107.xml,200,200,rolled-in_scale,117,94,181,198,149.0,146.0,64,104,0.6153846153846154
train,rolled-in_scale_108.xml,200,200,rolled-in_scale,15,36,128,166,71.5,101.0,113,130,0.8692307692307693
train,rolled-in_scale_109.xml,200,200,rolled-in_scale,70,68,159,198,114.5,133.0,89,130,0.6846153846153846
train,rolled-in_scale_11.xml,200,200,rolled-in_scale,33,31,91,120,62.0,75.5,58,89,0.651685393258427
train,rolled-in_scale_110.xml,200,200,rolled-in_scale,67,32,130,158,98.5,95.0,63,126,0.5
train,rolled-in_scale_111.xml,200,200,rolled-in_scale,149,87,190,156,169.5,121.5,41,69,0.5942028985507246
train,rolled-in_scale_112.xml,200,200,rolled-in_scale,129,81,187,200,158.0,140.5,58,119,0.48739495798319327
train,rolled-in_scale_113.xml,200,200,rolled-in_scale,69,44,135,200,102.0,122.0,66,156,0.4230769230769231
train,rolled-in_scale_113.xml,200,200,rolled-in_scale,159,1,199,131,179.0,66.0,40,130,0.3076923076923077
train,rolled-in_scale_114.xml,200,200,rolled-in_scale,3,6,64,195,33.5,100.5,61,189,0.32275132275132273
train,rolled-in_scale_114.xml,200,200,rolled-in_scale,88,27,125,88,106.5,57.5,37,61,0.6065573770491803
train,rolled-in_scale_115.xml,200,200,rolled-in_scale,63,2,136,199,99.5,100.5,73,197,0.37055837563451777
train,rolled-in_scale_115.xml,200,200,rolled-in_scale,161,1,197,51,179.0,26.0,36,50,0.72
train,rolled-in_scale_116.xml,200,200,rolled-in_scale,81,66,125,163,103.0,114.5,44,97,0.4536082474226804
train,rolled-in_scale_117.xml,200,200,rolled-in_scale,146,113,200,192,173.0,152.5,54,79,0.6835443037974683
train,rolled-in_scale_118.xml,200,200,rolled-in_scale,77,6,133,200,105.0,103.0,56,194,0.28865979381443296
train,rolled-in_scale_119.xml,200,200,rolled-in_scale,81,1,132,161,106.5,81.0,51,160,0.31875
train,rolled-in_scale_12.xml,200,200,rolled-in_scale,61,13,124,199,92.5,106.0,63,186,0.3387096774193548
train,rolled-in_scale_120.xml,200,200,rolled-in_scale,123,39,168,136,145.5,87.5,45,97,0.4639175257731959
train,rolled-in_scale_121.xml,200,200,rolled-in_scale,151,1,192,37,171.5,19.0,41,36,1.1388888888888888
train,rolled-in_scale_122.xml,200,200,rolled-in_scale,20,39,75,154,47.5,96.5,55,115,0.4782608695652174
train,rolled-in_scale_123.xml,200,200,rolled-in_scale,1,1,45,28,23.0,14.5,44,27,1.6296296296296295
train,rolled-in_scale_123.xml,200,200,rolled-in_scale,98,2,199,199,148.5,100.5,101,197,0.5126903553299492
train,rolled-in_scale_124.xml,200,200,rolled-in_scale,72,10,115,141,93.5,75.5,43,131,0.3282442748091603
train,rolled-in_scale_124.xml,200,200,rolled-in_scale,160,161,195,189,177.5,175.0,35,28,1.25
train,rolled-in_scale_125.xml,200,200,rolled-in_scale,17,140,66,189,41.5,164.5,49,49,1.0
train,rolled-in_scale_125.xml,200,200,rolled-in_scale,88,15,157,135,122.5,75.0,69,120,0.575
train,rolled-in_scale_126.xml,200,200,rolled-in_scale,71,1,122,200,96.5,100.5,51,199,0.2562814070351759
train,rolled-in_scale_126.xml,200,200,rolled-in_scale,143,146,199,200,171.0,173.0,56,54,1.037037037037037
train,rolled-in_scale_127.xml,200,200,rolled-in_scale,97,132,186,184,141.5,158.0,89,52,1.7115384615384615
train,rolled-in_scale_128.xml,200,200,rolled-in_scale,106,71,197,168,151.5,119.5,91,97,0.9381443298969072
train,rolled-in_scale_129.xml,200,200,rolled-in_scale,88,34,147,135,117.5,84.5,59,101,0.5841584158415841
train,rolled-in_scale_13.xml,200,200,rolled-in_scale,70,1,137,183,103.5,92.0,67,182,0.36813186813186816
train,rolled-in_scale_130.xml,200,200,rolled-in_scale,35,12,174,188,104.5,100.0,139,176,0.7897727272727273
train,rolled-in_scale_131.xml,200,200,rolled-in_scale,25,30,164,173,94.5,101.5,139,143,0.972027972027972
train,rolled-in_scale_132.xml,200,200,rolled-in_scale,69,5,177,69,123.0,37.0,108,64,1.6875
train,rolled-in_scale_133.xml,200,200,rolled-in_scale,41,3,150,160,95.5,81.5,109,157,0.6942675159235668
train,rolled-in_scale_134.xml,200,200,rolled-in_scale,28,14,85,161,56.5,87.5,57,147,0.3877551020408163
train,rolled-in_scale_134.xml,200,200,rolled-in_scale,87,77,169,154,128.0,115.5,82,77,1.0649350649350648
train,rolled-in_scale_135.xml,200,200,rolled-in_scale,32,40,93,172,62.5,106.0,61,132,0.4621212121212121
train,rolled-in_scale_136.xml,200,200,rolled-in_scale,57,70,179,194,118.0,132.0,122,124,0.9838709677419355
train,rolled-in_scale_137.xml,200,200,rolled-in_scale,50,74,95,106,72.5,90.0,45,32,1.40625
train,rolled-in_scale_137.xml,200,200,rolled-in_scale,99,158,145,200,122.0,179.0,46,42,1.0952380952380953
train,rolled-in_scale_138.xml,200,200,rolled-in_scale,71,44,136,184,103.5,114.0,65,140,0.4642857142857143
train,rolled-in_scale_139.xml,200,200,rolled-in_scale,101,81,181,200,141.0,140.5,80,119,0.6722689075630253
train,rolled-in_scale_14.xml,200,200,rolled-in_scale,98,22,148,113,123.0,67.5,50,91,0.5494505494505495
train,rolled-in_scale_140.xml,200,200,rolled-in_scale,57,88,143,200,100.0,144.0,86,112,0.7678571428571429
train,rolled-in_scale_141.xml,200,200,rolled-in_scale,9,28,121,110,65.0,69.0,112,82,1.3658536585365855
train,rolled-in_scale_141.xml,200,200,rolled-in_scale,134,47,192,188,163.0,117.5,58,141,0.41134751773049644
train,rolled-in_scale_142.xml,200,200,rolled-in_scale,52,25,128,98,90.0,61.5,76,73,1.0410958904109588
train,rolled-in_scale_143.xml,200,200,rolled-in_scale,75,52,155,189,115.0,120.5,80,137,0.583941605839416
train,rolled-in_scale_144.xml,200,200,rolled-in_scale,49,18,176,186,112.5,102.0,127,168,0.7559523809523809
train,rolled-in_scale_145.xml,200,200,rolled-in_scale,33,13,101,200,67.0,106.5,68,187,0.36363636363636365
train,rolled-in_scale_146.xml,200,200,rolled-in_scale,92,13,179,185,135.5,99.0,87,172,0.5058139534883721
train,rolled-in_scale_147.xml,200,200,rolled-in_scale,79,10,144,155,111.5,82.5,65,145,0.4482758620689655
train,rolled-in_scale_148.xml,200,200,rolled-in_scale,77,9,121,59,99.0,34.0,44,50,0.88
train,rolled-in_scale_148.xml,200,200,rolled-in_scale,122,63,178,131,150.0,97.0,56,68,0.8235294117647058
train,rolled-in_scale_149.xml,200,200,rolled-in_scale,49,1,137,193,93.0,97.0,88,192,0.4583333333333333
train,rolled-in_scale_149.xml,200,200,rolled-in_scale,160,66,192,175,176.0,120.5,32,109,0.29357798165137616
train,rolled-in_scale_150.xml,200,200,rolled-in_scale,33,1,170,193,101.5,97.0,137,192,0.7135416666666666
train,rolled-in_scale_151.xml,200,200,rolled-in_scale,109,1,198,197,153.5,99.0,89,196,0.45408163265306123
train,rolled-in_scale_152.xml,200,200,rolled-in_scale,2,1,131,197,66.5,99.0,129,196,0.6581632653061225
train,rolled-in_scale_153.xml,200,200,rolled-in_scale,71,3,192,197,131.5,100.0,121,194,0.6237113402061856
train,rolled-in_scale_154.xml,200,200,rolled-in_scale,123,58,195,113,159.0,85.5,72,55,1.309090909090909
train,rolled-in_scale_155.xml,200,200,rolled-in_scale,69,25,125,80,97.0,52.5,56,55,1.018181818181818
train,rolled-in_scale_156.xml,200,200,rolled-in_scale,20,28,68,182,44.0,105.0,48,154,0.3116883116883117
train,rolled-in_scale_156.xml,200,200,rolled-in_scale,97,85,147,140,122.0,112.5,50,55,0.9090909090909091
train,rolled-in_scale_157.xml,200,200,rolled-in_scale,59,22,145,182,102.0,102.0,86,160,0.5375
train,rolled-in_scale_158.xml,200,200,rolled-in_scale,15,120,81,192,48.0,156.0,66,72,0.9166666666666666
train,rolled-in_scale_159.xml,200,200,rolled-in_scale,31,59,74,161,52.5,110.0,43,102,0.4215686274509804
train,rolled-in_scale_16.xml,200,200,rolled-in_scale,56,94,109,192,82.5,143.0,53,98,0.5408163265306123
train,rolled-in_scale_16.xml,200,200,rolled-in_scale,157,66,183,94,170.0,80.0,26,28,0.9285714285714286
train,rolled-in_scale_160.xml,200,200,rolled-in_scale,39,1,84,200,61.5,100.5,45,199,0.22613065326633167
train,rolled-in_scale_160.xml,200,200,rolled-in_scale,100,149,200,200,150.0,174.5,100,51,1.9607843137254901
train,rolled-in_scale_161.xml,200,200,rolled-in_scale,22,4,89,200,55.5,102.0,67,196,0.34183673469387754
train,rolled-in_scale_162.xml,200,200,rolled-in_scale,6,50,98,192,52.0,121.0,92,142,0.647887323943662
train,rolled-in_scale_163.xml,200,200,rolled-in_scale,23,40,127,200,75.0,120.0,104,160,0.65
train,rolled-in_scale_164.xml,200,200,rolled-in_scale,57,52,112,138,84.5,95.0,55,86,0.6395348837209303
train,rolled-in_scale_165.xml,200,200,rolled-in_scale,24,52,109,139,66.5,95.5,85,87,0.9770114942528736
train,rolled-in_scale_165.xml,200,200,rolled-in_scale,135,122,181,195,158.0,158.5,46,73,0.6301369863013698
train,rolled-in_scale_166.xml,200,200,rolled-in_scale,13,12,169,191,91.0,101.5,156,179,0.8715083798882681
train,rolled-in_scale_167.xml,200,200,rolled-in_scale,4,19,123,145,63.5,82.0,119,126,0.9444444444444444
train,rolled-in_scale_168.xml,200,200,rolled-in_scale,42,52,122,149,82.0,100.5,80,97,0.8247422680412371
train,rolled-in_scale_168.xml,200,200,rolled-in_scale,165,116,200,167,182.5,141.5,35,51,0.6862745098039216
train,rolled-in_scale_169.xml,200,200,rolled-in_scale,23,1,147,187,85.0,94.0,124,186,0.6666666666666666
train,rolled-in_scale_17.xml,200,200,rolled-in_scale,30,18,98,77,64.0,47.5,68,59,1.152542372881356
train,rolled-in_scale_170.xml,200,200,rolled-in_scale,1,27,129,198,65.0,112.5,128,171,0.7485380116959064
train,rolled-in_scale_171.xml,200,200,rolled-in_scale,39,27,158,197,98.5,112.0,119,170,0.7
train,rolled-in_scale_172.xml,200,200,rolled-in_scale,67,3,200,194,133.5,98.5,133,191,0.6963350785340314
train,rolled-in_scale_173.xml,200,200,rolled-in_scale,8,75,114,198,61.0,136.5,106,123,0.8617886178861789
train,rolled-in_scale_174.xml,200,200,rolled-in_scale,31,26,123,193,77.0,109.5,92,167,0.5508982035928144
train,rolled-in_scale_175.xml,200,200,rolled-in_scale,101,33,188,193,144.5,113.0,87,160,0.54375
train,rolled-in_scale_176.xml,200,200,rolled-in_scale,74,16,170,159,122.0,87.5,96,143,0.6713286713286714
train,rolled-in_scale_177.xml,200,200,rolled-in_scale,28,1,183,198,105.5,99.5,155,197,0.7868020304568528
train,rolled-in_scale_178.xml,200,200,rolled-in_scale,1,1,162,183,81.5,92.0,161,182,0.8846153846153846
train,rolled-in_scale_179.xml,200,200,rolled-in_scale,2,3,81,112,41.5,57.5,79,109,0.7247706422018348
train,rolled-in_scale_18.xml,200,200,rolled-in_scale,111,1,179,196,145.0,98.5,68,195,0.3487179487179487
train,rolled-in_scale_180.xml,200,200,rolled-in_scale,13,1,78,64,45.5,32.5,65,63,1.0317460317460319
train,rolled-in_scale_180.xml,200,200,rolled-in_scale,144,68,193,155,168.5,111.5,49,87,0.5632183908045977
train,rolled-in_scale_181.xml,200,200,rolled-in_scale,62,57,128,170,95.0,113.5,66,113,0.584070796460177
train,rolled-in_scale_182.xml,200,200,rolled-in_scale,63,59,193,171,128.0,115.0,130,112,1.1607142857142858
train,rolled-in_scale_183.xml,200,200,rolled-in_scale,29,16,189,198,109.0,107.0,160,182,0.8791208791208791
train,rolled-in_scale_184.xml,200,200,rolled-in_scale,9,1,175,199,92.0,100.0,166,198,0.8383838383838383
train,rolled-in_scale_185.xml,200,200,rolled-in_scale,3,26,55,194,29.0,110.0,52,168,0.30952380952380953
train,rolled-in_scale_185.xml,200,200,rolled-in_scale,73,28,199,160,136.0,94.0,126,132,0.9545454545454546
train,rolled-in_scale_186.xml,200,200,rolled-in_scale,23,13,200,190,111.5,101.5,177,177,1.0
train,rolled-in_scale_187.xml,200,200,rolled-in_scale,32,22,199,196,115.5,109.0,167,174,0.9597701149425287
train,rolled-in_scale_188.xml,200,200,rolled-in_scale,31,13,105,199,68.0,106.0,74,186,0.3978494623655914
train,rolled-in_scale_189.xml,200,200,rolled-in_scale,49,37,105,149,77.0,93.0,56,112,0.5
train,rolled-in_scale_189.xml,200,200,rolled-in_scale,116,38,184,194,150.0,116.0,68,156,0.4358974358974359
train,rolled-in_scale_19.xml,200,200,rolled-in_scale,1,50,55,197,28.0,123.5,54,147,0.3673469387755102
train,rolled-in_scale_19.xml,200,200,rolled-in_scale,125,11,178,192,151.5,101.5,53,181,0.292817679558011
train,rolled-in_scale_190.xml,200,200,rolled-in_scale,1,77,45,155,23.0,116.0,44,78,0.5641025641025641
train,rolled-in_scale_190.xml,200,200,rolled-in_scale,62,1,185,193,123.5,97.0,123,192,0.640625
train,rolled-in_scale_191.xml,200,200,rolled-in_scale,1,40,46,112,23.5,76.0,45,72,0.625
train,rolled-in_scale_191.xml,200,200,rolled-in_scale,102,86,189,160,145.5,123.0,87,74,1.1756756756756757
train,rolled-in_scale_192.xml,200,200,rolled-in_scale,25,14,199,198,112.0,106.0,174,184,0.9456521739130435
train,rolled-in_scale_193.xml,200,200,rolled-in_scale,19,27,160,200,89.5,113.5,141,173,0.815028901734104
train,rolled-in_scale_194.xml,200,200,rolled-in_scale,7,35,138,198,72.5,116.5,131,163,0.803680981595092
train,rolled-in_scale_195.xml,200,200,rolled-in_scale,71,36,141,119,106.0,77.5,70,83,0.8433734939759037
train,rolled-in_scale_196.xml,200,200,rolled-in_scale,25,1,86,200,55.5,100.5,61,199,0.3065326633165829
train,rolled-in_scale_197.xml,200,200,rolled-in_scale,19,94,68,199,43.5,146.5,49,105,0.4666666666666667
train,rolled-in_scale_197.xml,200,200,rolled-in_scale,87,1,159,200,123.0,100.5,72,199,0.36180904522613067
train,rolled-in_scale_198.xml,200,200,rolled-in_scale,29,1,190,199,109.5,100.0,161,198,0.8131313131313131
train,rolled-in_scale_199.xml,200,200,rolled-in_scale,4,3,90,79,47.0,41.0,86,76,1.131578947368421
train,rolled-in_scale_199.xml,200,200,rolled-in_scale,105,22,169,175,137.0,98.5,64,153,0.41830065359477125
train,rolled-in_scale_2.xml,200,200,rolled-in_scale,148,87,197,187,172.5,137.0,49,100,0.49
train,rolled-in_scale_20.xml,200,200,rolled-in_scale,28,104,77,183,52.5,143.5,49,79,0.620253164556962
train,rolled-in_scale_20.xml,200,200,rolled-in_scale,106,1,199,194,152.5,97.5,93,193,0.48186528497409326
train,rolled-in_scale_200.xml,200,200,rolled-in_scale,61,97,177,199,119.0,148.0,116,102,1.1372549019607843
train,rolled-in_scale_201.xml,200,200,rolled-in_scale,45,21,160,128,102.5,74.5,115,107,1.074766355140187
train,rolled-in_scale_202.xml,200,200,rolled-in_scale,43,41,164,167,103.5,104.0,121,126,0.9603174603174603
train,rolled-in_scale_203.xml,200,200,rolled-in_scale,21,93,77,138,49.0,115.5,56,45,1.2444444444444445
train,rolled-in_scale_203.xml,200,200,rolled-in_scale,88,84,149,195,118.5,139.5,61,111,0.5495495495495496
train,rolled-in_scale_204.xml,200,200,rolled-in_scale,18,151,87,197,52.5,174.0,69,46,1.5
train,rolled-in_scale_204.xml,200,200,rolled-in_scale,102,60,168,192,135.0,126.0,66,132,0.5
train,rolled-in_scale_205.xml,200,200,rolled-in_scale,61,43,199,199,130.0,121.0,138,156,0.8846153846153846
train,rolled-in_scale_206.xml,200,200,rolled-in_scale,79,36,140,193,109.5,114.5,61,157,0.3885350318471338
train,rolled-in_scale_207.xml,200,200,rolled-in_scale,22,1,94,200,58.0,100.5,72,199,0.36180904522613067
train,rolled-in_scale_208.xml,200,200,rolled-in_scale,23,28,102,105,62.5,66.5,79,77,1.025974025974026
train,rolled-in_scale_208.xml,200,200,rolled-in_scale,115,51,178,194,146.5,122.5,63,143,0.4405594405594406
train,rolled-in_scale_209.xml,200,200,rolled-in_scale,35,18,156,197,95.5,107.5,121,179,0.6759776536312849
train,rolled-in_scale_21.xml,200,200,rolled-in_scale,56,104,107,177,81.5,140.5,51,73,0.6986301369863014
train,rolled-in_scale_21.xml,200,200,rolled-in_scale,138,1,197,196,167.5,98.5,59,195,0.30256410256410254
train,rolled-in_scale_210.xml,200,200,rolled-in_scale,42,38,105,188,73.5,113.0,63,150,0.42
train,rolled-in_scale_210.xml,200,200,rolled-in_scale,107,79,171,179,139.0,129.0,64,100,0.64
train,rolled-in_scale_211.xml,200,200,rolled-in_scale,94,4,168,198,131.0,101.0,74,194,0.38144329896907214
train,rolled-in_scale_212.xml,200,200,rolled-in_scale,66,1,175,191,120.5,96.0,109,190,0.5736842105263158
train,rolled-in_scale_213.xml,200,200,rolled-in_scale,51,89,179,199,115.0,144.0,128,110,1.1636363636363636
train,rolled-in_scale_214.xml,200,200,rolled-in_scale,74,29,122,198,98.0,113.5,48,169,0.28402366863905326
train,rolled-in_scale_214.xml,200,200,rolled-in_scale,165,41,189,121,177.0,81.0,24,80,0.3
train,rolled-in_scale_215.xml,200,200,rolled-in_scale,42,76,84,136,63.0,106.0,42,60,0.7
train,rolled-in_scale_215.xml,200,200,rolled-in_scale,112,35,157,194,134.5,114.5,45,159,0.2830188679245283
train,rolled-in_scale_216.xml,200,200,rolled-in_scale,14,71,69,175,41.5,123.0,55,104,0.5288461538461539
train,rolled-in_scale_216.xml,200,200,rolled-in_scale,83,69,156,165,119.5,117.0,73,96,0.7604166666666666
train,rolled-in_scale_217.xml,200,200,rolled-in_scale,13,31,71,168,42.0,99.5,58,137,0.4233576642335766
train,rolled-in_scale_218.xml,200,200,rolled-in_scale,69,28,146,156,107.5,92.0,77,128,0.6015625
train,rolled-in_scale_219.xml,200,200,rolled-in_scale,65,41,190,199,127.5,120.0,125,158,0.7911392405063291
train,rolled-in_scale_22.xml,200,200,rolled-in_scale,104,75,151,168,127.5,121.5,47,93,0.5053763440860215
train,rolled-in_scale_220.xml,200,200,rolled-in_scale,19,125,131,192,75.0,158.5,112,67,1.671641791044776
train,rolled-in_scale_221.xml,200,200,rolled-in_scale,96,32,149,164,122.5,98.0,53,132,0.4015151515151515
train,rolled-in_scale_222.xml,200,200,rolled-in_scale,112,45,198,198,155.0,121.5,86,153,0.5620915032679739
train,rolled-in_scale_223.xml,200,200,rolled-in_scale,25,4,96,155,60.5,79.5,71,151,0.47019867549668876
train,rolled-in_scale_224.xml,200,200,rolled-in_scale,14,18,192,199,103.0,108.5,178,181,0.9834254143646409
train,rolled-in_scale_225.xml,200,200,rolled-in_scale,18,26,106,148,62.0,87.0,88,122,0.7213114754098361
train,rolled-in_scale_225.xml,200,200,rolled-in_scale,134,47,200,122,167.0,84.5,66,75,0.88
train,rolled-in_scale_226.xml,200,200,rolled-in_scale,71,1,158,152,114.5,76.5,87,151,0.5761589403973509
train,rolled-in_scale_227.xml,200,200,rolled-in_scale,44,110,184,198,114.0,154.0,140,88,1.5909090909090908
train,rolled-in_scale_228.xml,200,200,rolled-in_scale,47,1,176,199,111.5,100.0,129,198,0.6515151515151515
train,rolled-in_scale_229.xml,200,200,rolled-in_scale,90,15,199,200,144.5,107.5,109,185,0.5891891891891892
train,rolled-in_scale_23.xml,200,200,rolled-in_scale,59,50,108,140,83.5,95.0,49,90,0.5444444444444444
train,rolled-in_scale_23.xml,200,200,rolled-in_scale,134,83,194,200,164.0,141.5,60,117,0.5128205128205128
train,rolled-in_scale_230.xml,200,200,rolled-in_scale,14,1,114,134,64.0,67.5,100,133,0.7518796992481203
train,rolled-in_scale_231.xml,200,200,rolled-in_scale,1,1,66,178,33.5,89.5,65,177,0.3672316384180791
train,rolled-in_scale_231.xml,200,200,rolled-in_scale,109,117,161,196,135.0,156.5,52,79,0.6582278481012658
train,rolled-in_scale_232.xml,200,200,rolled-in_scale,43,23,118,129,80.5,76.0,75,106,0.7075471698113207
train,rolled-in_scale_233.xml,200,200,rolled-in_scale,17,73,83,198,50.0,135.5,66,125,0.528
train,rolled-in_scale_234.xml,200,200,rolled-in_scale,9,1,88,194,48.5,97.5,79,193,0.40932642487046633
train,rolled-in_scale_235.xml,200,200,rolled-in_scale,14,12,111,159,62.5,85.5,97,147,0.6598639455782312
train,rolled-in_scale_236.xml,200,200,rolled-in_scale,46,50,145,138,95.5,94.0,99,88,1.125
train,rolled-in_scale_237.xml,200,200,rolled-in_scale,83,24,175,179,129.0,101.5,92,155,0.5935483870967742
train,rolled-in_scale_238.xml,200,200,rolled-in_scale,29,27,153,195,91.0,111.0,124,168,0.7380952380952381
train,rolled-in_scale_239.xml,200,200,rolled-in_scale,68,76,128,147,98.0,111.5,60,71,0.8450704225352113
train,rolled-in_scale_24.xml,200,200,rolled-in_scale,3,1,79,191,41.0,96.0,76,190,0.4
train,rolled-in_scale_24.xml,200,200,rolled-in_scale,160,59,187,89,173.5,74.0,27,30,0.9
train,rolled-in_scale_240.xml,200,200,rolled-in_scale,58,24,139,162,98.5,93.0,81,138,0.5869565217391305
train,rolled-in_scale_25.xml,200,200,rolled-in_scale,53,48,106,163,79.5,105.5,53,115,0.4608695652173913
train,rolled-in_scale_25.xml,200,200,rolled-in_scale,137,127,178,193,157.5,160.0,41,66,0.6212121212121212
train,rolled-in_scale_26.xml,200,200,rolled-in_scale,19,20,86,173,52.5,96.5,67,153,0.43790849673202614
train,rolled-in_scale_26.xml,200,200,rolled-in_scale,114,60,157,119,135.5,89.5,43,59,0.7288135593220338
train,rolled-in_scale_28.xml,200,200,rolled-in_scale,90,67,150,136,120.0,101.5,60,69,0.8695652173913043
train,rolled-in_scale_29.xml,200,200,rolled-in_scale,36,74,72,123,54.0,98.5,36,49,0.7346938775510204
train,rolled-in_scale_29.xml,200,200,rolled-in_scale,90,2,192,163,141.0,82.5,102,161,0.6335403726708074
train,rolled-in_scale_3.xml,200,200,rolled-in_scale,68,1,145,139,106.5,70.0,77,138,0.5579710144927537
train,rolled-in_scale_30.xml,200,200,rolled-in_scale,43,20,149,112,96.0,66.0,106,92,1.1521739130434783
train,rolled-in_scale_31.xml,200,200,rolled-in_scale,81,128,151,191,116.0,159.5,70,63,1.1111111111111112
train,rolled-in_scale_32.xml,200,200,rolled-in_scale,85,37,137,103,111.0,70.0,52,66,0.7878787878787878
train,rolled-in_scale_33.xml,200,200,rolled-in_scale,119,31,172,123,145.5,77.0,53,92,0.5760869565217391
train,rolled-in_scale_34.xml,200,200,rolled-in_scale,43,18,91,70,67.0,44.0,48,52,0.9230769230769231
train,rolled-in_scale_35.xml,200,200,rolled-in_scale,117,8,193,199,155.0,103.5,76,191,0.39790575916230364
train,rolled-in_scale_36.xml,200,200,rolled-in_scale,65,9,154,199,109.5,104.0,89,190,0.46842105263157896
train,rolled-in_scale_37.xml,200,200,rolled-in_scale,32,13,119,199,75.5,106.0,87,186,0.46774193548387094
train,rolled-in_scale_38.xml,200,200,rolled-in_scale,116,16,191,189,153.5,102.5,75,173,0.43352601156069365
train,rolled-in_scale_39.xml,200,200,rolled-in_scale,46,7,156,190,101.0,98.5,110,183,0.6010928961748634
train,rolled-in_scale_4.xml,200,200,rolled-in_scale,40,1,138,199,89.0,100.0,98,198,0.494949494949495
train,rolled-in_scale_40.xml,200,200,rolled-in_scale,1,10,83,191,42.0,100.5,82,181,0.4530386740331492
train,rolled-in_scale_40.xml,200,200,rolled-in_scale,132,20,187,64,159.5,42.0,55,44,1.25
train,rolled-in_scale_41.xml,200,200,rolled-in_scale,120,1,197,199,158.5,100.0,77,198,0.3888888888888889
train,rolled-in_scale_42.xml,200,200,rolled-in_scale,71,8,155,198,113.0,103.0,84,190,0.4421052631578947
train,rolled-in_scale_43.xml,200,200,rolled-in_scale,20,7,109,197,64.5,102.0,89,190,0.46842105263157896
train,rolled-in_scale_44.xml,200,200,rolled-in_scale,121,9,186,199,153.5,104.0,65,190,0.34210526315789475
train,rolled-in_scale_45.xml,200,200,rolled-in_scale,119,68,170,199,144.5,133.5,51,131,0.3893129770992366
train,rolled-in_scale_46.xml,200,200,rolled-in_scale,18,1,85,200,51.5,100.5,67,199,0.33668341708542715
train,rolled-in_scale_47.xml,200,200,rolled-in_scale,33,17,109,199,71.0,108.0,76,182,0.4175824175824176
train,rolled-in_scale_48.xml,200,200,rolled-in_scale,110,29,200,197,155.0,113.0,90,168,0.5357142857142857
train,rolled-in_scale_49.xml,200,200,rolled-in_scale,14,24,153,187,83.5,105.5,139,163,0.852760736196319
train,rolled-in_scale_5.xml,200,200,rolled-in_scale,32,25,120,189,76.0,107.0,88,164,0.5365853658536586
train,rolled-in_scale_50.xml,200,200,rolled-in_scale,2,3,52,53,27.0,28.0,50,50,1.0
train,rolled-in_scale_50.xml,200,200,rolled-in_scale,59,1,163,199,111.0,100.0,104,198,0.5252525252525253
train,rolled-in_scale_51.xml,200,200,rolled-in_scale,1,161,81,200,41.0,180.5,80,39,2.051282051282051
train,rolled-in_scale_51.xml,200,200,rolled-in_scale,132,3,200,156,166.0,79.5,68,153,0.4444444444444444
train,rolled-in_scale_52.xml,200,200,rolled-in_scale,24,84,124,140,74.0,112.0,100,56,1.7857142857142858
train,rolled-in_scale_52.xml,200,200,rolled-in_scale,140,7,200,197,170.0,102.0,60,190,0.3157894736842105
train,rolled-in_scale_53.xml,200,200,rolled-in_scale,117,1,194,177,155.5,89.0,77,176,0.4375
train,rolled-in_scale_54.xml,200,200,rolled-in_scale,74,14,138,179,106.0,96.5,64,165,0.3878787878787879
train,rolled-in_scale_55.xml,200,200,rolled-in_scale,6,22,66,177,36.0,99.5,60,155,0.3870967741935484
train,rolled-in_scale_55.xml,200,200,rolled-in_scale,145,12,175,60,160.0,36.0,30,48,0.625
train,rolled-in_scale_56.xml,200,200,rolled-in_scale,82,13,152,182,117.0,97.5,70,169,0.41420118343195267
train,rolled-in_scale_57.xml,200,200,rolled-in_scale,29,42,196,194,112.5,118.0,167,152,1.0986842105263157
train,rolled-in_scale_58.xml,200,200,rolled-in_scale,84,57,132,184,108.0,120.5,48,127,0.3779527559055118
train,rolled-in_scale_59.xml,200,200,rolled-in_scale,76,56,175,158,125.5,107.0,99,102,0.9705882352941176
train,rolled-in_scale_6.xml,200,200,rolled-in_scale,23,15,116,199,69.5,107.0,93,184,0.5054347826086957
train,rolled-in_scale_60.xml,200,200,rolled-in_scale,42,10,155,200,98.5,105.0,113,190,0.5947368421052631
train,rolled-in_scale_61.xml,200,200,rolled-in_scale,74,56,138,199,106.0,127.5,64,143,0.44755244755244755
train,rolled-in_scale_62.xml,200,200,rolled-in_scale,94,1,181,200,137.5,100.5,87,199,0.4371859296482412
train,rolled-in_scale_63.xml,200,200,rolled-in_scale,54,9,158,148,106.0,78.5,104,139,0.7482014388489209
train,rolled-in_scale_64.xml,200,200,rolled-in_scale,86,1,198,147,142.0,74.0,112,146,0.7671232876712328
train,rolled-in_scale_65.xml,200,200,rolled-in_scale,46,1,157,150,101.5,75.5,111,149,0.7449664429530202
train,rolled-in_scale_66.xml,200,200,rolled-in_scale,1,3,102,145,51.5,74.0,101,142,0.7112676056338029
train,rolled-in_scale_67.xml,200,200,rolled-in_scale,32,1,162,103,97.0,52.0,130,102,1.2745098039215685
train,rolled-in_scale_67.xml,200,200,rolled-in_scale,166,152,198,198,182.0,175.0,32,46,0.6956521739130435
train,rolled-in_scale_68.xml,200,200,rolled-in_scale,82,113,200,200,141.0,156.5,118,87,1.3563218390804597
train,rolled-in_scale_69.xml,200,200,rolled-in_scale,32,91,164,200,98.0,145.5,132,109,1.2110091743119267
train,rolled-in_scale_7.xml,200,200,rolled-in_scale,68,62,139,160,103.5,111.0,71,98,0.7244897959183674
train,rolled-in_scale_70.xml,200,200,rolled-in_scale,2,76,103,200,52.5,138.0,101,124,0.8145161290322581
train,rolled-in_scale_70.xml,200,200,rolled-in_scale,141,169,197,195,169.0,182.0,56,26,2.1538461538461537
train,rolled-in_scale_71.xml,200,200,rolled-in_scale,79,1,187,171,133.0,86.0,108,170,0.6352941176470588
train,rolled-in_scale_72.xml,200,200,rolled-in_scale,9,21,110,200,59.5,110.5,101,179,0.5642458100558659
train,rolled-in_scale_72.xml,200,200,rolled-in_scale,153,79,199,105,176.0,92.0,46,26,1.7692307692307692
train,rolled-in_scale_73.xml,200,200,rolled-in_scale,104,27,178,181,141.0,104.0,74,154,0.4805194805194805
train,rolled-in_scale_74.xml,200,200,rolled-in_scale,61,61,158,184,109.5,122.5,97,123,0.7886178861788617
train,rolled-in_scale_75.xml,200,200,rolled-in_scale,37,11,172,159,104.5,85.0,135,148,0.9121621621621622
train,rolled-in_scale_76.xml,200,200,rolled-in_scale,93,9,199,138,146.0,73.5,106,129,0.8217054263565892
train,rolled-in_scale_77.xml,200,200,rolled-in_scale,57,3,159,198,108.0,100.5,102,195,0.5230769230769231
train,rolled-in_scale_78.xml,200,200,rolled-in_scale,83,11,179,197,131.0,104.0,96,186,0.5161290322580645
train,rolled-in_scale_79.xml,200,200,rolled-in_scale,30,27,140,172,85.0,99.5,110,145,0.7586206896551724
train,rolled-in_scale_8.xml,200,200,rolled-in_scale,28,25,166,186,97.0,105.5,138,161,0.8571428571428571
train,rolled-in_scale_80.xml,200,200,rolled-in_scale,105,1,195,198,150.0,99.5,90,197,0.45685279187817257
train,rolled-in_scale_81.xml,200,200,rolled-in_scale,21,11,151,199,86.0,105.0,130,188,0.6914893617021277
train,rolled-in_scale_82.xml,200,200,rolled-in_scale,54,7,157,174,105.5,90.5,103,167,0.6167664670658682
train,rolled-in_scale_83.xml,200,200,rolled-in_scale,49,1,196,196,122.5,98.5,147,195,0.7538461538461538
train,rolled-in_scale_84.xml,200,200,rolled-in_scale,81,70,180,199,130.5,134.5,99,129,0.7674418604651163
train,rolled-in_scale_85.xml,200,200,rolled-in_scale,130,10,189,200,159.5,105.0,59,190,0.3105263157894737
train,rolled-in_scale_86.xml,200,200,rolled-in_scale,61,14,180,199,120.5,106.5,119,185,0.6432432432432432
train,rolled-in_scale_87.xml,200,200,rolled-in_scale,117,1,197,178,157.0,89.5,80,177,0.4519774011299435
train,rolled-in_scale_88.xml,200,200,rolled-in_scale,41,27,166,166,103.5,96.5,125,139,0.8992805755395683
train,rolled-in_scale_89.xml,200,200,rolled-in_scale,9,1,133,113,71.0,57.0,124,112,1.1071428571428572
train,rolled-in_scale_9.xml,200,200,rolled-in_scale,74,42,174,102,124.0,72.0,100,60,1.6666666666666667
train,rolled-in_scale_90.xml,200,200,rolled-in_scale,74,1,199,197,136.5,99.0,125,196,0.6377551020408163
train,rolled-in_scale_91.xml,200,200,rolled-in_scale,3,1,138,187,70.5,94.0,135,186,0.7258064516129032
train,rolled-in_scale_92.xml,200,200,rolled-in_scale,99,32,163,180,131.0,106.0,64,148,0.43243243243243246
train,rolled-in_scale_93.xml,200,200,rolled-in_scale,57,54,178,200,117.5,127.0,121,146,0.8287671232876712
train,rolled-in_scale_94.xml,200,200,rolled-in_scale,86,9,154,162,120.0,85.5,68,153,0.4444444444444444
train,rolled-in_scale_95.xml,200,200,rolled-in_scale,52,16,172,161,112.0,88.5,120,145,0.8275862068965517
train,rolled-in_scale_96.xml,200,200,rolled-in_scale,45,14,183,200,114.0,107.0,138,186,0.7419354838709677
train,rolled-in_scale_97.xml,200,200,rolled-in_scale,62,12,151,186,106.5,99.0,89,174,0.5114942528735632
train,rolled-in_scale_98.xml,200,200,rolled-in_scale,9,12,84,196,46.5,104.0,75,184,0.4076086956521739
train,rolled-in_scale_98.xml,200,200,rolled-in_scale,122,49,196,200,159.0,124.5,74,151,0.4900662251655629
train,rolled-in_scale_99.xml,200,200,rolled-in_scale,21,77,68,117,44.5,97.0,47,40,1.175
train,rolled-in_scale_99.xml,200,200,rolled-in_scale,125,33,195,196,160.0,114.5,70,163,0.4294478527607362
train,scratches_1.xml,200,200,scratches,26,12,43,171,34.5,91.5,17,159,0.1069182389937107
train,scratches_10.xml,200,200,scratches,74,1,119,124,96.5,62.5,45,123,0.36585365853658536
train,scratches_10.xml,200,200,scratches,139,1,154,196,146.5,98.5,15,195,0.07692307692307693
train,scratches_10.xml,200,200,scratches,84,77,111,150,97.5,113.5,27,73,0.3698630136986301
train,scratches_100.xml,200,200,scratches,1,94,200,122,100.5,108.0,199,28,7.107142857142857
train,scratches_101.xml,200,200,scratches,1,67,199,96,100.0,81.5,198,29,6.827586206896552
train,scratches_102.xml,200,200,scratches,1,61,200,89,100.5,75.0,199,28,7.107142857142857
train,scratches_103.xml,200,200,scratches,1,84,172,109,86.5,96.5,171,25,6.84
train,scratches_104.xml,200,200,scratches,1,22,199,54,100.0,38.0,198,32,6.1875
train,scratches_105.xml,200,200,scratches,1,32,199,58,100.0,45.0,198,26,7.615384615384615
train,scratches_106.xml,200,200,scratches,2,27,199,53,100.5,40.0,197,26,7.576923076923077
train,scratches_107.xml,200,200,scratches,1,22,199,50,100.0,36.0,198,28,7.071428571428571
train,scratches_108.xml,200,200,scratches,42,1,76,199,59.0,100.0,34,198,0.1717171717171717
train,scratches_108.xml,200,200,inclusion,7,145,20,179,13.5,162.0,13,34,0.38235294117647056
train,scratches_108.xml,200,200,inclusion,133,129,150,193,141.5,161.0,17,64,0.265625
train,scratches_108.xml,200,200,inclusion,159,134,178,184,168.5,159.0,19,50,0.38
train,scratches_109.xml,200,200,scratches,120,1,155,199,137.5,100.0,35,198,0.17676767676767677
train,scratches_109.xml,200,200,inclusion,22,102,38,177,30.0,139.5,16,75,0.21333333333333335
train,scratches_109.xml,200,200,inclusion,69,29,82,65,75.5,47.0,13,36,0.3611111111111111
train,scratches_109.xml,200,200,inclusion,83,139,95,178,89.0,158.5,12,39,0.3076923076923077
train,scratches_11.xml,200,200,scratches,5,1,43,147,24.0,74.0,38,146,0.2602739726027397
train,scratches_11.xml,200,200,scratches,64,13,81,199,72.5,106.0,17,186,0.0913978494623656
train,scratches_110.xml,200,200,scratches,16,1,61,198,38.5,99.5,45,197,0.22842639593908629
train,scratches_110.xml,200,200,inclusion,108,19,126,105,117.0,62.0,18,86,0.20930232558139536
train,scratches_110.xml,200,200,inclusion,134,26,153,70,143.5,48.0,19,44,0.4318181818181818
train,scratches_111.xml,200,200,scratches,50,1,95,199,72.5,100.0,45,198,0.22727272727272727
train,scratches_111.xml,200,200,inclusion,18,1,29,27,23.5,14.0,11,26,0.4230769230769231
train,scratches_111.xml,200,200,inclusion,144,1,161,71,152.5,36.0,17,70,0.24285714285714285
train,scratches_111.xml,200,200,inclusion,170,1,187,39,178.5,20.0,17,38,0.4473684210526316
train,scratches_112.xml,200,200,scratches,1,1,39,199,20.0,100.0,38,198,0.1919191919191919
train,scratches_113.xml,200,200,scratches,69,1,97,199,83.0,100.0,28,198,0.1414141414141414
train,scratches_113.xml,200,200,scratches,53,1,69,200,61.0,100.5,16,199,0.08040201005025126
train,scratches_113.xml,200,200,inclusion,161,170,172,193,166.5,181.5,11,23,0.4782608695652174
train,scratches_114.xml,200,200,scratches,133,1,144,199,138.5,100.0,11,198,0.05555555555555555
train,scratches_114.xml,200,200,scratches,46,91,59,200,52.5,145.5,13,109,0.11926605504587157
train,scratches_114.xml,200,200,scratches,142,1,178,199,160.0,100.0,36,198,0.18181818181818182
train,scratches_115.xml,200,200,scratches,47,1,75,199,61.0,100.0,28,198,0.1414141414141414
train,scratches_115.xml,200,200,scratches,29,1,44,199,36.5,100.0,15,198,0.07575757575757576
train,scratches_115.xml,200,200,inclusion,138,86,151,121,144.5,103.5,13,35,0.37142857142857144
train,scratches_116.xml,200,200,scratches,84,1,95,199,89.5,100.0,11,198,0.05555555555555555
train,scratches_116.xml,200,200,scratches,104,1,131,199,117.5,100.0,27,198,0.13636363636363635
train,scratches_117.xml,200,200,scratches,24,40,34,199,29.0,119.5,10,159,0.06289308176100629
train,scratches_117.xml,200,200,scratches,108,1,122,199,115.0,100.0,14,198,0.0707070707070707
train,scratches_117.xml,200,200,scratches,129,1,154,199,141.5,100.0,25,198,0.12626262626262627
train,scratches_118.xml,200,200,scratches,45,1,58,184,51.5,92.5,13,183,0.07103825136612021
train,scratches_118.xml,200,200,scratches,64,1,92,200,78.0,100.5,28,199,0.1407035175879397
train,scratches_118.xml,200,200,inclusion,172,116,185,150,178.5,133.0,13,34,0.38235294117647056
train,scratches_119.xml,200,200,scratches,82,1,93,188,87.5,94.5,11,187,0.058823529411764705
train,scratches_119.xml,200,200,scratches,99,1,132,200,115.5,100.5,33,199,0.1658291457286432
train,scratches_12.xml,200,200,scratches,20,61,35,185,27.5,123.0,15,124,0.12096774193548387
train,scratches_12.xml,200,200,scratches,23,1,36,46,29.5,23.5,13,45,0.28888888888888886
train,scratches_120.xml,200,200,scratches,102,1,134,199,118.0,100.0,32,198,0.16161616161616163
train,scratches_120.xml,200,200,inclusion,11,118,22,149,16.5,133.5,11,31,0.3548387096774194
train,scratches_121.xml,200,200,scratches,11,1,42,199,26.5,100.0,31,198,0.15656565656565657
train,scratches_121.xml,200,200,scratches,139,7,164,143,151.5,75.0,25,136,0.18382352941176472
train,scratches_121.xml,200,200,inclusion,170,16,199,109,184.5,62.5,29,93,0.3118279569892473
train,scratches_122.xml,200,200,scratches,16,1,64,198,40.0,99.5,48,197,0.2436548223350254
train,scratches_122.xml,200,200,inclusion,171,137,196,170,183.5,153.5,25,33,0.7575757575757576
train,scratches_123.xml,200,200,scratches,81,1,129,159,105.0,80.0,48,158,0.3037974683544304
train,scratches_123.xml,200,200,scratches,55,1,67,164,61.0,82.5,12,163,0.0736196319018405
train,scratches_123.xml,200,200,scratches,27,1,43,163,35.0,82.0,16,162,0.09876543209876543
train,scratches_124.xml,200,200,scratches,53,1,67,93,60.0,47.0,14,92,0.15217391304347827
train,scratches_124.xml,200,200,scratches,145,1,155,69,150.0,35.0,10,68,0.14705882352941177
train,scratches_125.xml,200,200,scratches,20,52,196,156,108.0,104.0,176,104,1.6923076923076923
train,scratches_126.xml,200,200,scratches,4,14,186,96,95.0,55.0,182,82,2.2195121951219514
train,scratches_127.xml,200,200,scratches,123,1,143,198,133.0,99.5,20,197,0.10152284263959391
train,scratches_127.xml,200,200,inclusion,165,1,200,200,182.5,100.5,35,199,0.17587939698492464
train,scratches_128.xml,200,200,scratches,45,1,66,194,55.5,97.5,21,193,0.10880829015544041
train,scratches_128.xml,200,200,inclusion,83,1,185,196,134.0,98.5,102,195,0.5230769230769231
train,scratches_129.xml,200,200,scratches,88,1,108,199,98.0,100.0,20,198,0.10101010101010101
train,scratches_129.xml,200,200,inclusion,126,1,198,197,162.0,99.0,72,196,0.3673469387755102
train,scratches_13.xml,200,200,scratches,94,57,110,86,102.0,71.5,16,29,0.5517241379310345
train,scratches_13.xml,200,200,scratches,173,110,197,197,185.0,153.5,24,87,0.27586206896551724
train,scratches_130.xml,200,200,scratches,54,15,71,198,62.5,106.5,17,183,0.09289617486338798
train,scratches_130.xml,200,200,inclusion,15,24,45,101,30.0,62.5,30,77,0.38961038961038963
train,scratches_130.xml,200,200,inclusion,96,1,175,197,135.5,99.0,79,196,0.4030612244897959
train,scratches_131.xml,200,200,scratches,67,12,94,156,80.5,84.0,27,144,0.1875
train,scratches_131.xml,200,200,scratches,140,6,155,198,147.5,102.0,15,192,0.078125
train,scratches_131.xml,200,200,inclusion,98,34,129,107,113.5,70.5,31,73,0.4246575342465753
train,scratches_131.xml,200,200,inclusion,171,34,200,200,185.5,117.0,29,166,0.1746987951807229
train,scratches_132.xml,200,200,scratches,103,1,120,96,111.5,48.5,17,95,0.17894736842105263
train,scratches_132.xml,200,200,scratches,2,100,196,194,99.0,147.0,194,94,2.0638297872340425
train,scratches_132.xml,200,200,inclusion,133,1,200,198,166.5,99.5,67,197,0.3401015228426396
train,scratches_133.xml,200,200,scratches,62,1,107,199,84.5,100.0,45,198,0.22727272727272727
train,scratches_134.xml,200,200,scratches,25,1,68,198,46.5,99.5,43,197,0.2182741116751269
train,scratches_135.xml,200,200,scratches,128,1,166,199,147.0,100.0,38,198,0.1919191919191919
train,scratches_135.xml,200,200,inclusion,35,28,51,63,43.0,45.5,16,35,0.45714285714285713
train,scratches_136.xml,200,200,scratches,49,1,87,199,68.0,100.0,38,198,0.1919191919191919
train,scratches_137.xml,200,200,scratches,89,1,125,197,107.0,99.0,36,196,0.1836734693877551
train,scratches_137.xml,200,200,inclusion,38,124,52,164,45.0,144.0,14,40,0.35
train,scratches_138.xml,200,200,scratches,143,1,178,199,160.5,100.0,35,198,0.17676767676767677
train,scratches_138.xml,200,200,inclusion,92,120,105,158,98.5,139.0,13,38,0.34210526315789475
train,scratches_139.xml,200,200,scratches,17,1,55,199,36.0,100.0,38,198,0.1919191919191919
train,scratches_139.xml,200,200,inclusion,107,112,127,200,117.0,156.0,20,88,0.22727272727272727
train,scratches_139.xml,200,200,inclusion,133,116,153,173,143.0,144.5,20,57,0.3508771929824561
train,scratches_14.xml,200,200,scratches,32,15,47,43,39.5,29.0,15,28,0.5357142857142857
train,scratches_14.xml,200,200,scratches,111,58,142,153,126.5,105.5,31,95,0.3263157894736842
train,scratches_140.xml,200,200,scratches,87,1,128,199,107.5,100.0,41,198,0.20707070707070707
train,scratches_140.xml,200,200,inclusion,19,112,39,189,29.0,150.5,20,77,0.2597402597402597
train,scratches_140.xml,200,200,inclusion,52,83,66,120,59.0,101.5,14,37,0.3783783783783784
train,scratches_140.xml,200,200,inclusion,179,71,195,156,187.0,113.5,16,85,0.18823529411764706
train,scratches_141.xml,200,200,scratches,132,1,178,199,155.0,100.0,46,198,0.23232323232323232
train,scratches_141.xml,200,200,inclusion,18,1,58,109,38.0,55.0,40,108,0.37037037037037035
train,scratches_141.xml,200,200,inclusion,62,50,85,116,73.5,83.0,23,66,0.3484848484848485
train,scratches_141.xml,200,200,inclusion,96,17,108,50,102.0,33.5,12,33,0.36363636363636365
train,scratches_142.xml,200,200,scratches,81,1,97,198,89.0,99.5,16,197,0.08121827411167512
train,scratches_142.xml,200,200,scratches,92,1,127,199,109.5,100.0,35,198,0.17676767676767677
train,scratches_143.xml,200,200,scratches,14,1,28,199,21.0,100.0,14,198,0.0707070707070707
train,scratches_143.xml,200,200,scratches,33,1,60,199,46.5,100.0,27,198,0.13636363636363635
train,scratches_144.xml,200,200,scratches,49,73,62,198,55.5,135.5,13,125,0.104
train,scratches_144.xml,200,200,scratches,132,1,148,199,140.0,100.0,16,198,0.08080808080808081
train,scratches_144.xml,200,200,scratches,154,1,178,199,166.0,100.0,24,198,0.12121212121212122
train,scratches_145.xml,200,200,scratches,73,1,89,199,81.0,100.0,16,198,0.08080808080808081
train,scratches_145.xml,200,200,scratches,94,1,121,200,107.5,100.5,27,199,0.135678391959799
train,scratches_146.xml,200,200,scratches,47,1,60,150,53.5,75.5,13,149,0.087248322147651
train,scratches_146.xml,200,200,scratches,66,1,95,199,80.5,100.0,29,198,0.14646464646464646
train,scratches_146.xml,200,200,inclusion,176,82,188,111,182.0,96.5,12,29,0.41379310344827586
train,scratches_147.xml,200,200,scratches,67,1,78,131,72.5,66.0,11,130,0.08461538461538462
train,scratches_147.xml,200,200,scratches,81,1,115,199,98.0,100.0,34,198,0.1717171717171717
train,scratches_148.xml,200,200,scratches,129,1,144,150,136.5,75.5,15,149,0.10067114093959731
train,scratches_148.xml,200,200,scratches,149,1,182,199,165.5,100.0,33,198,0.16666666666666666
train,scratches_149.xml,200,200,scratches,74,1,121,195,97.5,98.0,47,194,0.2422680412371134
train,scratches_15.xml,200,200,scratches,36,36,67,107,51.5,71.5,31,71,0.43661971830985913
train,scratches_15.xml,200,200,scratches,125,28,136,68,130.5,48.0,11,40,0.275
train,scratches_15.xml,200,200,scratches,119,127,133,198,126.0,162.5,14,71,0.19718309859154928
train,scratches_15.xml,200,200,scratches,46,77,63,127,54.5,102.0,17,50,0.34
train,scratches_150.xml,200,200,scratches,126,1,144,199,135.0,100.0,18,198,0.09090909090909091
train,scratches_151.xml,200,200,scratches,15,113,31,200,23.0,156.5,16,87,0.1839080459770115
train,scratches_151.xml,200,200,scratches,97,1,124,199,110.5,100.0,27,198,0.13636363636363635
train,scratches_152.xml,200,200,scratches,26,1,53,200,39.5,100.5,27,199,0.135678391959799
train,scratches_153.xml,200,200,scratches,114,106,127,199,120.5,152.5,13,93,0.13978494623655913
train,scratches_153.xml,200,200,scratches,83,108,96,198,89.5,153.0,13,90,0.14444444444444443
train,scratches_154.xml,200,200,scratches,56,97,77,200,66.5,148.5,21,103,0.20388349514563106
train,scratches_154.xml,200,200,scratches,98,14,115,105,106.5,59.5,17,91,0.18681318681318682
train,scratches_154.xml,200,200,scratches,126,10,148,186,137.0,98.0,22,176,0.125
train,scratches_155.xml,200,200,scratches,26,32,41,124,33.5,78.0,15,92,0.16304347826086957
train,scratches_155.xml,200,200,scratches,56,26,73,199,64.5,112.5,17,173,0.09826589595375723
train,scratches_155.xml,200,200,scratches,133,1,163,199,148.0,100.0,30,198,0.15151515151515152
train,scratches_156.xml,200,200,scratches,46,1,81,200,63.5,100.5,35,199,0.17587939698492464
train,scratches_156.xml,200,200,scratches,102,65,117,200,109.5,132.5,15,135,0.1111111111111111
train,scratches_157.xml,200,200,scratches,46,1,79,199,62.5,100.0,33,198,0.16666666666666666
train,scratches_157.xml,200,200,scratches,99,1,115,199,107.0,100.0,16,198,0.08080808080808081
train,scratches_158.xml,200,200,scratches,46,1,67,199,56.5,100.0,21,198,0.10606060606060606
train,scratches_158.xml,200,200,scratches,87,70,104,200,95.5,135.0,17,130,0.13076923076923078
train,scratches_158.xml,200,200,scratches,118,1,135,160,126.5,80.5,17,159,0.1069182389937107
train,scratches_159.xml,200,200,scratches,127,1,158,182,142.5,91.5,31,181,0.1712707182320442
train,scratches_159.xml,200,200,scratches,168,1,190,134,179.0,67.5,22,133,0.16541353383458646
train,scratches_16.xml,200,200,scratches,31,30,42,66,36.5,48.0,11,36,0.3055555555555556
train,scratches_16.xml,200,200,scratches,25,126,41,199,33.0,162.5,16,73,0.2191780821917808
train,scratches_160.xml,200,200,scratches,30,1,66,133,48.0,67.0,36,132,0.2727272727272727
train,scratches_160.xml,200,200,scratches,71,1,101,105,86.0,53.0,30,104,0.28846153846153844
train,scratches_160.xml,200,200,scratches,94,78,113,200,103.5,139.0,19,122,0.1557377049180328
train,scratches_161.xml,200,200,scratches,40,1,57,137,48.5,69.0,17,136,0.125
train,scratches_161.xml,200,200,scratches,131,27,160,200,145.5,113.5,29,173,0.1676300578034682
train,scratches_162.xml,200,200,scratches,34,1,62,198,48.0,99.5,28,197,0.14213197969543148
train,scratches_162.xml,200,200,scratches,77,28,108,187,92.5,107.5,31,159,0.1949685534591195
train,scratches_163.xml,200,200,scratches,1,1,17,198,9.0,99.5,16,197,0.08121827411167512
train,scratches_163.xml,200,200,scratches,39,77,52,199,45.5,138.0,13,122,0.10655737704918032
train,scratches_163.xml,200,200,scratches,71,1,86,165,78.5,83.0,15,164,0.09146341463414634
train,scratches_163.xml,200,200,scratches,149,2,182,198,165.5,100.0,33,196,0.1683673469387755
train,scratches_164.xml,200,200,scratches,14,10,29,183,21.5,96.5,15,173,0.08670520231213873
train,scratches_164.xml,200,200,scratches,88,1,127,197,107.5,99.0,39,196,0.1989795918367347
train,scratches_164.xml,200,200,scratches,140,1,161,196,150.5,98.5,21,195,0.1076923076923077
train,scratches_165.xml,200,200,scratches,61,1,97,166,79.0,83.5,36,165,0.21818181818181817
train,scratches_165.xml,200,200,scratches,109,1,129,198,119.0,99.5,20,197,0.10152284263959391
train,scratches_166.xml,200,200,scratches,24,1,56,199,40.0,100.0,32,198,0.16161616161616163
train,scratches_166.xml,200,200,scratches,75,1,94,199,84.5,100.0,19,198,0.09595959595959595
train,scratches_166.xml,200,200,scratches,160,107,171,198,165.5,152.5,11,91,0.12087912087912088
train,scratches_166.xml,200,200,scratches,180,1,193,99,186.5,50.0,13,98,0.1326530612244898
train,scratches_167.xml,200,200,scratches,84,1,98,197,91.0,99.0,14,196,0.07142857142857142
train,scratches_167.xml,200,200,scratches,128,1,144,198,136.0,99.5,16,197,0.08121827411167512
train,scratches_168.xml,200,200,scratches,117,1,146,86,131.5,43.5,29,85,0.3411764705882353
train,scratches_168.xml,200,200,scratches,65,16,81,107,73.0,61.5,16,91,0.17582417582417584
train,scratches_168.xml,200,200,scratches,54,129,101,198,77.5,163.5,47,69,0.6811594202898551
train,scratches_169.xml,200,200,scratches,128,4,147,199,137.5,101.5,19,195,0.09743589743589744
train,scratches_17.xml,200,200,scratches,153,87,167,176,160.0,131.5,14,89,0.15730337078651685
train,scratches_170.xml,200,200,scratches,88,1,106,200,97.0,100.5,18,199,0.09045226130653267
train,scratches_171.xml,200,200,scratches,85,1,100,97,92.5,49.0,15,96,0.15625
train,scratches_171.xml,200,200,scratches,84,126,103,200,93.5,163.0,19,74,0.25675675675675674
train,scratches_172.xml,200,200,scratches,28,16,52,153,40.0,84.5,24,137,0.17518248175182483
train,scratches_172.xml,200,200,scratches,143,10,168,198,155.5,104.0,25,188,0.13297872340425532
train,scratches_173.xml,200,200,scratches,74,1,95,159,84.5,80.0,21,158,0.13291139240506328
train,scratches_174.xml,200,200,scratches,20,1,37,199,28.5,100.0,17,198,0.08585858585858586
train,scratches_174.xml,200,200,scratches,121,15,138,200,129.5,107.5,17,185,0.0918918918918919
train,scratches_174.xml,200,200,scratches,168,23,180,200,174.0,111.5,12,177,0.06779661016949153
train,scratches_175.xml,200,200,scratches,116,1,142,200,129.0,100.5,26,199,0.1306532663316583
train,scratches_175.xml,200,200,scratches,165,58,177,199,171.0,128.5,12,141,0.0851063829787234
train,scratches_176.xml,200,200,scratches,101,1,129,199,115.0,100.0,28,198,0.1414141414141414
train,scratches_176.xml,200,200,scratches,151,28,163,199,157.0,113.5,12,171,0.07017543859649122
train,scratches_177.xml,200,200,scratches,41,1,70,199,55.5,100.0,29,198,0.14646464646464646
train,scratches_177.xml,200,200,scratches,91,1,106,199,98.5,100.0,15,198,0.07575757575757576
train,scratches_178.xml,200,200,scratches,93,1,120,199,106.5,100.0,27,198,0.13636363636363635
train,scratches_179.xml,200,200,scratches,56,1,88,199,72.0,100.0,32,198,0.16161616161616163
train,scratches_18.xml,200,200,scratches,46,22,58,128,52.0,75.0,12,106,0.11320754716981132
train,scratches_180.xml,200,200,scratches,129,1,160,199,144.5,100.0,31,198,0.15656565656565657
train,scratches_181.xml,200,200,scratches,85,1,116,199,100.5,100.0,31,198,0.15656565656565657
train,scratches_182.xml,200,200,scratches,54,1,86,199,70.0,100.0,32,198,0.16161616161616163
train,scratches_183.xml,200,200,scratches,32,1,62,200,47.0,100.5,30,199,0.1507537688442211
train,scratches_183.xml,200,200,scratches,174,3,191,92,182.5,47.5,17,89,0.19101123595505617
train,scratches_184.xml,200,200,scratches,146,1,173,199,159.5,100.0,27,198,0.13636363636363635
train,scratches_185.xml,200,200,scratches,89,1,116,200,102.5,100.5,27,199,0.135678391959799
train,scratches_186.xml,200,200,scratches,18,1,50,200,34.0,100.5,32,199,0.16080402010050251
train,scratches_186.xml,200,200,scratches,142,86,186,143,164.0,114.5,44,57,0.7719298245614035
train,scratches_186.xml,200,200,scratches,154,1,179,176,166.5,88.5,25,175,0.14285714285714285
train,scratches_187.xml,200,200,scratches,24,1,60,199,42.0,100.0,36,198,0.18181818181818182
train,scratches_188.xml,200,200,scratches,100,1,131,199,115.5,100.0,31,198,0.15656565656565657
train,scratches_188.xml,200,200,scratches,73,7,98,60,85.5,33.5,25,53,0.4716981132075472
train,scratches_189.xml,200,200,scratches,145,1,180,199,162.5,100.0,35,198,0.17676767676767677
train,scratches_189.xml,200,200,scratches,122,28,145,76,133.5,52.0,23,48,0.4791666666666667
train,scratches_19.xml,200,200,scratches,163,16,178,175,170.5,95.5,15,159,0.09433962264150944
train,scratches_190.xml,200,200,scratches,154,1,183,198,168.5,99.5,29,197,0.14720812182741116
train,scratches_191.xml,200,200,scratches,21,1,45,200,33.0,100.5,24,199,0.12060301507537688
train,scratches_192.xml,200,200,scratches,100,1,119,196,109.5,98.5,19,195,0.09743589743589744
train,scratches_193.xml,200,200,scratches,121,1,139,134,130.0,67.5,18,133,0.13533834586466165
train,scratches_194.xml,200,200,scratches,23,1,41,170,32.0,85.5,18,169,0.10650887573964497
train,scratches_194.xml,200,200,scratches,109,30,129,129,119.0,79.5,20,99,0.20202020202020202
train,scratches_195.xml,200,200,scratches,39,67,52,199,45.5,133.0,13,132,0.09848484848484848
train,scratches_196.xml,200,200,scratches,24,1,37,200,30.5,100.5,13,199,0.06532663316582915
train,scratches_197.xml,200,200,scratches,113,1,127,198,120.0,99.5,14,197,0.07106598984771574
train,scratches_197.xml,200,200,scratches,33,1,45,198,39.0,99.5,12,197,0.06091370558375635
train,scratches_198.xml,200,200,scratches,31,48,42,199,36.5,123.5,11,151,0.0728476821192053
train,scratches_198.xml,200,200,scratches,108,1,123,200,115.5,100.5,15,199,0.07537688442211055
train,scratches_198.xml,200,200,scratches,31,1,44,59,37.5,30.0,13,58,0.22413793103448276
train,scratches_199.xml,200,200,scratches,69,13,85,197,77.0,105.0,16,184,0.08695652173913043
train,scratches_199.xml,200,200,scratches,142,1,159,154,150.5,77.5,17,153,0.1111111111111111
train,scratches_2.xml,200,200,scratches,92,24,106,176,99.0,100.0,14,152,0.09210526315789473
train,scratches_20.xml,200,200,scratches,28,76,45,200,36.5,138.0,17,124,0.13709677419354838
train,scratches_200.xml,200,200,scratches,119,6,137,200,128.0,103.0,18,194,0.09278350515463918
train,scratches_201.xml,200,200,scratches,79,1,97,199,88.0,100.0,18,198,0.09090909090909091
train,scratches_202.xml,200,200,scratches,52,41,62,117,57.0,79.0,10,76,0.13157894736842105
train,scratches_202.xml,200,200,scratches,71,126,81,199,76.0,162.5,10,73,0.136986301369863
train,scratches_203.xml,200,200,scratches,64,2,77,200,70.5,101.0,13,198,0.06565656565656566
train,scratches_204.xml,200,200,scratches,61,1,81,196,71.0,98.5,20,195,0.10256410256410256
train,scratches_205.xml,200,200,scratches,135,29,148,196,141.5,112.5,13,167,0.07784431137724551
train,scratches_205.xml,200,200,scratches,32,1,47,177,39.5,89.0,15,176,0.08522727272727272
train,scratches_206.xml,200,200,scratches,109,3,128,130,118.5,66.5,19,127,0.14960629921259844
train,scratches_206.xml,200,200,scratches,137,50,154,198,145.5,124.0,17,148,0.11486486486486487
train,scratches_207.xml,200,200,scratches,51,1,70,82,60.5,41.5,19,81,0.2345679012345679
train,scratches_207.xml,200,200,scratches,78,2,96,199,87.0,100.5,18,197,0.09137055837563451
train,scratches_208.xml,200,200,scratches,115,1,131,196,123.0,98.5,16,195,0.08205128205128205
train,scratches_209.xml,200,200,scratches,53,1,69,132,61.0,66.5,16,131,0.12213740458015267
train,scratches_209.xml,200,200,scratches,114,1,144,147,129.0,74.0,30,146,0.2054794520547945
train,scratches_209.xml,200,200,inclusion,115,47,199,94,157.0,70.5,84,47,1.7872340425531914
train,scratches_21.xml,200,200,scratches,92,23,109,199,100.5,111.0,17,176,0.09659090909090909
train,scratches_21.xml,200,200,scratches,52,144,94,199,73.0,171.5,42,55,0.7636363636363637
train,scratches_210.xml,200,200,scratches,63,1,83,197,73.0,99.0,20,196,0.10204081632653061
train,scratches_210.xml,200,200,scratches,130,1,161,198,145.5,99.5,31,197,0.15736040609137056
train,scratches_210.xml,200,200,inclusion,137,28,200,164,168.5,96.0,63,136,0.4632352941176471
train,scratches_211.xml,200,200,scratches,64,1,80,198,72.0,99.5,16,197,0.08121827411167512
train,scratches_211.xml,200,200,scratches,138,1,170,196,154.0,98.5,32,195,0.1641025641025641
train,scratches_211.xml,200,200,inclusion,152,152,198,182,175.0,167.0,46,30,1.5333333333333334
train,scratches_212.xml,200,200,scratches,16,1,29,200,22.5,100.5,13,199,0.06532663316582915
train,scratches_212.xml,200,200,scratches,133,1,151,200,142.0,100.5,18,199,0.09045226130653267
train,scratches_213.xml,200,200,scratches,44,2,68,199,56.0,100.5,24,197,0.1218274111675127
train,scratches_213.xml,200,200,scratches,127,1,154,200,140.5,100.5,27,199,0.135678391959799
train,scratches_214.xml,200,200,scratches,14,43,32,198,23.0,120.5,18,155,0.11612903225806452
train,scratches_214.xml,200,200,scratches,128,1,154,200,141.0,100.5,26,199,0.1306532663316583
train,scratches_215.xml,200,200,scratches,28,1,53,199,40.5,100.0,25,198,0.12626262626262627
train,scratches_215.xml,200,200,scratches,114,48,141,200,127.5,124.0,27,152,0.17763157894736842
train,scratches_216.xml,200,200,scratches,14,51,32,182,23.0,116.5,18,131,0.13740458015267176
train,scratches_216.xml,200,200,scratches,42,100,65,198,53.5,149.0,23,98,0.23469387755102042
train,scratches_216.xml,200,200,scratches,155,2,182,198,168.5,100.0,27,196,0.1377551020408163
train,scratches_216.xml,200,200,inclusion,1,1,52,34,26.5,17.5,51,33,1.5454545454545454
train,scratches_217.xml,200,200,scratches,32,1,64,198,48.0,99.5,32,197,0.16243654822335024
train,scratches_217.xml,200,200,scratches,101,1,116,54,108.5,27.5,15,53,0.2830188679245283
train,scratches_217.xml,200,200,scratches,128,139,148,199,138.0,169.0,20,60,0.3333333333333333
train,scratches_218.xml,200,200,scratches,57,55,88,198,72.5,126.5,31,143,0.21678321678321677
train,scratches_218.xml,200,200,scratches,48,1,62,66,55.0,33.5,14,65,0.2153846153846154
train,scratches_218.xml,200,200,scratches,125,59,142,159,133.5,109.0,17,100,0.17
train,scratches_218.xml,200,200,scratches,12,64,26,163,19.0,113.5,14,99,0.1414141414141414
train,scratches_219.xml,200,200,scratches,83,4,99,117,91.0,60.5,16,113,0.1415929203539823
train,scratches_219.xml,200,200,scratches,160,111,178,199,169.0,155.0,18,88,0.20454545454545456
train,scratches_219.xml,200,200,scratches,48,114,62,197,55.0,155.5,14,83,0.1686746987951807
train,scratches_219.xml,200,200,scratches,107,75,129,198,118.0,136.5,22,123,0.17886178861788618
train,scratches_22.xml,200,200,scratches,21,1,34,76,27.5,38.5,13,75,0.17333333333333334
train,scratches_22.xml,200,200,scratches,19,100,33,197,26.0,148.5,14,97,0.14432989690721648
train,scratches_22.xml,200,200,scratches,1,14,23,51,12.0,32.5,22,37,0.5945945945945946
train,scratches_220.xml,200,200,scratches,141,1,165,116,153.0,58.5,24,115,0.20869565217391303
train,scratches_220.xml,200,200,scratches,105,1,135,112,120.0,56.5,30,111,0.2702702702702703
train,scratches_220.xml,200,200,scratches,79,16,93,193,86.0,104.5,14,177,0.07909604519774012
train,scratches_221.xml,200,200,scratches,17,1,47,144,32.0,72.5,30,143,0.2097902097902098
train,scratches_221.xml,200,200,scratches,156,31,174,180,165.0,105.5,18,149,0.12080536912751678
train,scratches_221.xml,200,200,scratches,85,1,110,148,97.5,74.5,25,147,0.17006802721088435
train,scratches_222.xml,200,200,scratches,39,101,58,200,48.5,150.5,19,99,0.1919191919191919
train,scratches_222.xml,200,200,scratches,98,2,117,147,107.5,74.5,19,145,0.1310344827586207
train,scratches_222.xml,200,200,scratches,28,21,45,86,36.5,53.5,17,65,0.26153846153846155
train,scratches_222.xml,200,200,inclusion,155,2,186,197,170.5,99.5,31,195,0.15897435897435896
train,scratches_223.xml,200,200,scratches,59,8,81,105,70.0,56.5,22,97,0.2268041237113402
train,scratches_223.xml,200,200,scratches,127,108,144,200,135.5,154.0,17,92,0.18478260869565216
train,scratches_224.xml,200,200,scratches,40,27,55,172,47.5,99.5,15,145,0.10344827586206896
train,scratches_224.xml,200,200,scratches,134,37,145,200,139.5,118.5,11,163,0.06748466257668712
train,scratches_224.xml,200,200,scratches,105,58,117,199,111.0,128.5,12,141,0.0851063829787234
train,scratches_225.xml,200,200,scratches,53,52,70,155,61.5,103.5,17,103,0.1650485436893204
train,scratches_225.xml,200,200,scratches,173,1,186,86,179.5,43.5,13,85,0.15294117647058825
train,scratches_225.xml,200,200,scratches,1,3,16,184,8.5,93.5,15,181,0.08287292817679558
train,scratches_225.xml,200,200,inclusion,174,179,199,200,186.5,189.5,25,21,1.1904761904761905
train,scratches_226.xml,200,200,scratches,71,11,84,199,77.5,105.0,13,188,0.06914893617021277
train,scratches_226.xml,200,200,scratches,38,4,56,184,47.0,94.0,18,180,0.1
train,scratches_226.xml,200,200,inclusion,1,100,53,164,27.0,132.0,52,64,0.8125
train,scratches_227.xml,200,200,scratches,74,33,100,200,87.0,116.5,26,167,0.15568862275449102
train,scratches_228.xml,200,200,scratches,21,7,37,200,29.0,103.5,16,193,0.08290155440414508
train,scratches_228.xml,200,200,pitted_surface,67,55,131,187,99.0,121.0,64,132,0.48484848484848486
train,scratches_228.xml,200,200,patches,167,89,200,122,183.5,105.5,33,33,1.0
train,scratches_229.xml,200,200,scratches,71,55,87,200,79.0,127.5,16,145,0.1103448275862069
train,scratches_229.xml,200,200,inclusion,95,1,114,41,104.5,21.0,19,40,0.475
train,scratches_23.xml,200,200,scratches,128,1,141,56,134.5,28.5,13,55,0.23636363636363636
train,scratches_23.xml,200,200,scratches,122,90,140,199,131.0,144.5,18,109,0.1651376146788991
train,scratches_23.xml,200,200,scratches,38,2,124,198,81.0,100.0,86,196,0.4387755102040816
train,scratches_230.xml,200,200,scratches,108,4,125,199,116.5,101.5,17,195,0.08717948717948718
train,scratches_230.xml,200,200,scratches,45,3,60,199,52.5,101.0,15,196,0.07653061224489796
train,scratches_230.xml,200,200,scratches,80,2,96,168,88.0,85.0,16,166,0.0963855421686747
train,scratches_230.xml,200,200,scratches,161,10,177,168,169.0,89.0,16,158,0.10126582278481013
train,scratches_231.xml,200,200,scratches,13,1,45,195,29.0,98.0,32,194,0.16494845360824742
train,scratches_231.xml,200,200,scratches,145,3,160,200,152.5,101.5,15,197,0.07614213197969544
train,scratches_231.xml,200,200,inclusion,12,120,100,151,56.0,135.5,88,31,2.838709677419355
train,scratches_232.xml,200,200,scratches,143,74,160,179,151.5,126.5,17,105,0.1619047619047619
train,scratches_232.xml,200,200,scratches,37,69,170,82,103.5,75.5,133,13,10.23076923076923
train,scratches_233.xml,200,200,scratches,3,61,200,80,101.5,70.5,197,19,10.368421052631579
train,scratches_233.xml,200,200,scratches,1,144,70,156,35.5,150.0,69,12,5.75
train,scratches_233.xml,200,200,inclusion,79,152,91,189,85.0,170.5,12,37,0.32432432432432434
train,scratches_234.xml,200,200,scratches,1,68,179,85,90.0,76.5,178,17,10.470588235294118
train,scratches_234.xml,200,200,scratches,15,137,198,158,106.5,147.5,183,21,8.714285714285714
train,scratches_235.xml,200,200,scratches,1,79,198,94,99.5,86.5,197,15,13.133333333333333
train,scratches_236.xml,200,200,scratches,44,90,189,106,116.5,98.0,145,16,9.0625
train,scratches_236.xml,200,200,scratches,1,117,124,135,62.5,126.0,123,18,6.833333333333333
train,scratches_236.xml,200,200,inclusion,155,25,165,110,160.0,67.5,10,85,0.11764705882352941
train,scratches_237.xml,200,200,scratches,26,158,199,176,112.5,167.0,173,18,9.61111111111111
train,scratches_237.xml,200,200,scratches,1,37,196,52,98.5,44.5,195,15,13.0
train,scratches_238.xml,200,200,scratches,1,22,112,37,56.5,29.5,111,15,7.4
train,scratches_238.xml,200,200,scratches,1,133,199,167,100.0,150.0,198,34,5.823529411764706
train,scratches_239.xml,200,200,scratches,55,152,157,169,106.0,160.5,102,17,6.0
train,scratches_239.xml,200,200,scratches,4,87,197,116,100.5,101.5,193,29,6.655172413793103
train,scratches_239.xml,200,200,scratches,152,76,200,89,176.0,82.5,48,13,3.6923076923076925
train,scratches_24.xml,200,200,scratches,17,1,56,198,36.5,99.5,39,197,0.19796954314720813
train,scratches_240.xml,200,200,scratches,53,132,199,160,126.0,146.0,146,28,5.214285714285714
train,scratches_240.xml,200,200,scratches,61,102,199,128,130.0,115.0,138,26,5.3076923076923075
train,scratches_240.xml,200,200,scratches,13,75,156,88,84.5,81.5,143,13,11.0
train,scratches_25.xml,200,200,scratches,35,1,97,198,66.0,99.5,62,197,0.3147208121827411
train,scratches_25.xml,200,200,scratches,112,5,151,198,131.5,101.5,39,193,0.20207253886010362
train,scratches_26.xml,200,200,scratches,19,1,60,133,39.5,67.0,41,132,0.3106060606060606
train,scratches_26.xml,200,200,scratches,41,149,59,199,50.0,174.0,18,50,0.36
train,scratches_27.xml,200,200,scratches,13,1,59,199,36.0,100.0,46,198,0.23232323232323232
train,scratches_27.xml,200,200,scratches,61,92,90,157,75.5,124.5,29,65,0.4461538461538462
train,scratches_27.xml,200,200,scratches,103,6,143,144,123.0,75.0,40,138,0.2898550724637681
train,scratches_27.xml,200,200,scratches,127,146,144,199,135.5,172.5,17,53,0.32075471698113206
train,scratches_28.xml,200,200,scratches,8,14,24,98,16.0,56.0,16,84,0.19047619047619047
train,scratches_28.xml,200,200,scratches,9,144,22,199,15.5,171.5,13,55,0.23636363636363636
train,scratches_29.xml,200,200,scratches,52,61,80,158,66.0,109.5,28,97,0.28865979381443296
train,scratches_29.xml,200,200,scratches,93,119,109,199,101.0,159.0,16,80,0.2
train,scratches_29.xml,200,200,scratches,94,1,111,70,102.5,35.5,17,69,0.2463768115942029
train,scratches_3.xml,200,200,scratches,148,165,176,199,162.0,182.0,28,34,0.8235294117647058
train,scratches_3.xml,200,200,scratches,167,40,179,121,173.0,80.5,12,81,0.14814814814814814
train,scratches_30.xml,200,200,scratches,14,1,34,73,24.0,37.0,20,72,0.2777777777777778
train,scratches_30.xml,200,200,scratches,61,1,77,26,69.0,13.5,16,25,0.64
train,scratches_30.xml,200,200,scratches,129,18,143,97,136.0,57.5,14,79,0.17721518987341772
train,scratches_30.xml,200,200,scratches,88,91,114,190,101.0,140.5,26,99,0.26262626262626265
train,scratches_30.xml,200,200,scratches,130,149,142,198,136.0,173.5,12,49,0.24489795918367346
train,scratches_31.xml,200,200,scratches,126,1,140,80,133.0,40.5,14,79,0.17721518987341772
train,scratches_31.xml,200,200,scratches,123,115,137,199,130.0,157.0,14,84,0.16666666666666666
train,scratches_32.xml,200,200,scratches,31,1,44,42,37.5,21.5,13,41,0.3170731707317073
train,scratches_32.xml,200,200,scratches,27,68,42,187,34.5,127.5,15,119,0.12605042016806722
train,scratches_32.xml,200,200,scratches,177,61,193,180,185.0,120.5,16,119,0.13445378151260504
train,scratches_32.xml,200,200,inclusion,105,84,120,116,112.5,100.0,15,32,0.46875
train,scratches_33.xml,200,200,scratches,107,30,124,150,115.5,90.0,17,120,0.14166666666666666
train,scratches_33.xml,200,200,inclusion,38,47,52,80,45.0,63.5,14,33,0.42424242424242425
train,scratches_34.xml,200,200,scratches,135,37,160,198,147.5,117.5,25,161,0.15527950310559005
train,scratches_35.xml,200,200,scratches,104,10,128,199,116.0,104.5,24,189,0.12698412698412698
train,scratches_36.xml,200,200,scratches,38,10,62,199,50.0,104.5,24,189,0.12698412698412698
train,scratches_37.xml,200,200,scratches,156,1,183,200,169.5,100.5,27,199,0.135678391959799
train,scratches_38.xml,200,200,scratches,96,1,122,199,109.0,100.0,26,198,0.13131313131313133
train,scratches_39.xml,200,200,scratches,12,1,39,199,25.5,100.0,27,198,0.13636363636363635
train,scratches_4.xml,200,200,scratches,157,62,199,199,178.0,130.5,42,137,0.30656934306569344
train,scratches_40.xml,200,200,scratches,121,1,144,199,132.5,100.0,23,198,0.11616161616161616
train,scratches_41.xml,200,200,scratches,28,1,55,199,41.5,100.0,27,198,0.13636363636363635
train,scratches_42.xml,200,200,scratches,93,1,122,182,107.5,91.5,29,181,0.16022099447513813
train,scratches_43.xml,200,200,scratches,79,14,95,188,87.0,101.0,16,174,0.09195402298850575
train,scratches_44.xml,200,200,scratches,93,8,111,190,102.0,99.0,18,182,0.0989010989010989
train,scratches_45.xml,200,200,scratches,1,78,199,100,100.0,89.0,198,22,9.0
train,scratches_46.xml,200,200,scratches,1,149,194,169,97.5,159.0,193,20,9.65
train,scratches_47.xml,200,200,scratches,28,44,52,199,40.0,121.5,24,155,0.15483870967741936
train,scratches_48.xml,200,200,scratches,157,44,181,198,169.0,121.0,24,154,0.15584415584415584
train,scratches_48.xml,200,200,inclusion,36,1,53,43,44.5,22.0,17,42,0.40476190476190477
train,scratches_49.xml,200,200,scratches,80,32,107,199,93.5,115.5,27,167,0.16167664670658682
train,scratches_5.xml,200,200,scratches,140,40,198,199,169.0,119.5,58,159,0.36477987421383645
train,scratches_50.xml,200,200,scratches,34,1,67,198,50.5,99.5,33,197,0.16751269035532995
train,scratches_51.xml,200,200,scratches,134,1,163,198,148.5,99.5,29,197,0.14720812182741116
train,scratches_52.xml,200,200,scratches,97,1,130,199,113.5,100.0,33,198,0.16666666666666666
train,scratches_53.xml,200,200,scratches,144,1,184,198,164.0,99.5,40,197,0.20304568527918782
train,scratches_54.xml,200,200,scratches,32,1,76,199,54.0,100.0,44,198,0.2222222222222222
train,scratches_55.xml,200,200,scratches,86,1,126,199,106.0,100.0,40,198,0.20202020202020202
train,scratches_56.xml,200,200,scratches,131,1,168,198,149.5,99.5,37,197,0.18781725888324874
train,scratches_57.xml,200,200,scratches,70,1,102,156,86.0,78.5,32,155,0.2064516129032258
train,scratches_58.xml,200,200,scratches,18,1,50,181,34.0,91.0,32,180,0.17777777777777778
train,scratches_59.xml,200,200,scratches,1,85,198,119,99.5,102.0,197,34,5.794117647058823
train,scratches_6.xml,200,200,scratches,89,17,153,198,121.0,107.5,64,181,0.35359116022099446
train,scratches_6.xml,200,200,scratches,151,46,164,137,157.5,91.5,13,91,0.14285714285714285
train,scratches_60.xml,200,200,scratches,1,165,198,195,99.5,180.0,197,30,6.566666666666666
train,scratches_61.xml,200,200,scratches,1,25,190,57,95.5,41.0,189,32,5.90625
train,scratches_62.xml,200,200,scratches,21,25,199,54,110.0,39.5,178,29,6.137931034482759
train,scratches_63.xml,200,200,scratches,1,119,177,152,89.0,135.5,176,33,5.333333333333333
train,scratches_64.xml,200,200,scratches,1,27,197,60,99.0,43.5,196,33,5.9393939393939394
train,scratches_65.xml,200,200,scratches,2,129,199,157,100.5,143.0,197,28,7.035714285714286
train,scratches_66.xml,200,200,scratches,77,1,97,198,87.0,99.5,20,197,0.10152284263959391
train,scratches_66.xml,200,200,scratches,103,1,123,198,113.0,99.5,20,197,0.10152284263959391
train,scratches_66.xml,200,200,scratches,130,13,145,120,137.5,66.5,15,107,0.14018691588785046
train,scratches_67.xml,200,200,scratches,33,1,52,198,42.5,99.5,19,197,0.09644670050761421
train,scratches_67.xml,200,200,scratches,57,23,71,198,64.0,110.5,14,175,0.08
train,scratches_68.xml,200,200,scratches,5,30,27,198,16.0,114.0,22,168,0.13095238095238096
train,scratches_68.xml,200,200,scratches,32,44,51,162,41.5,103.0,19,118,0.16101694915254236
train,scratches_68.xml,200,200,scratches,108,62,123,195,115.5,128.5,15,133,0.11278195488721804
train,scratches_69.xml,200,200,scratches,148,1,163,198,155.5,99.5,15,197,0.07614213197969544
train,scratches_69.xml,200,200,inclusion,85,18,107,105,96.0,61.5,22,87,0.25287356321839083
train,scratches_7.xml,200,200,scratches,17,3,82,198,49.5,100.5,65,195,0.3333333333333333
train,scratches_7.xml,200,200,scratches,80,40,93,110,86.5,75.0,13,70,0.18571428571428572
train,scratches_7.xml,200,200,inclusion,127,1,148,47,137.5,24.0,21,46,0.45652173913043476
train,scratches_70.xml,200,200,scratches,126,5,145,191,135.5,98.0,19,186,0.10215053763440861
train,scratches_70.xml,200,200,scratches,164,1,176,191,170.0,96.0,12,190,0.06315789473684211
train,scratches_71.xml,200,200,scratches,84,4,98,199,91.0,101.5,14,195,0.07179487179487179
train,scratches_72.xml,200,200,scratches,18,4,32,197,25.0,100.5,14,193,0.07253886010362694
train,scratches_73.xml,200,200,scratches,165,1,177,185,171.0,93.0,12,184,0.06521739130434782
train,scratches_74.xml,200,200,scratches,143,123,160,196,151.5,159.5,17,73,0.2328767123287671
train,scratches_74.xml,200,200,scratches,174,65,188,196,181.0,130.5,14,131,0.10687022900763359
train,scratches_75.xml,200,200,scratches,34,91,53,192,43.5,141.5,19,101,0.18811881188118812
train,scratches_75.xml,200,200,scratches,66,37,79,184,72.5,110.5,13,147,0.08843537414965986
train,scratches_75.xml,200,200,scratches,130,8,141,186,135.5,97.0,11,178,0.06179775280898876
train,scratches_76.xml,200,200,scratches,160,34,173,199,166.5,116.5,13,165,0.07878787878787878
train,scratches_77.xml,200,200,scratches,169,1,184,198,176.5,99.5,15,197,0.07614213197969544
train,scratches_77.xml,200,200,scratches,104,40,115,198,109.5,119.0,11,158,0.06962025316455696
train,scratches_78.xml,200,200,scratches,101,10,116,199,108.5,104.5,15,189,0.07936507936507936
train,scratches_78.xml,200,200,scratches,151,16,162,199,156.5,107.5,11,183,0.060109289617486336
train,scratches_78.xml,200,200,scratches,37,57,47,197,42.0,127.0,10,140,0.07142857142857142
train,scratches_79.xml,200,200,scratches,51,6,69,200,60.0,103.0,18,194,0.09278350515463918
train,scratches_79.xml,200,200,scratches,101,22,115,200,108.0,111.0,14,178,0.07865168539325842
train,scratches_8.xml,200,200,scratches,158,1,199,147,178.5,74.0,41,146,0.2808219178082192
train,scratches_8.xml,200,200,scratches,169,107,189,170,179.0,138.5,20,63,0.31746031746031744
train,scratches_80.xml,200,200,scratches,139,1,152,199,145.5,100.0,13,198,0.06565656565656566
train,scratches_81.xml,200,200,scratches,75,1,89,195,82.0,98.0,14,194,0.07216494845360824
train,scratches_81.xml,200,200,scratches,142,1,156,170,149.0,85.5,14,169,0.08284023668639054
train,scratches_82.xml,200,200,scratches,24,3,36,179,30.0,91.0,12,176,0.06818181818181818
train,scratches_82.xml,200,200,scratches,90,1,105,167,97.5,84.0,15,166,0.09036144578313253
train,scratches_82.xml,200,200,scratches,140,1,151,176,145.5,88.5,11,175,0.06285714285714286
train,scratches_83.xml,200,200,scratches,23,1,37,128,30.0,64.5,14,127,0.11023622047244094
train,scratches_83.xml,200,200,scratches,74,1,84,141,79.0,71.0,10,140,0.07142857142857142
train,scratches_84.xml,200,200,scratches,142,19,153,196,147.5,107.5,11,177,0.062146892655367235
train,scratches_85.xml,200,200,scratches,103,15,118,197,110.5,106.0,15,182,0.08241758241758242
train,scratches_85.xml,200,200,scratches,172,33,180,198,176.0,115.5,8,165,0.048484848484848485
train,scratches_86.xml,200,200,scratches,40,12,52,199,46.0,105.5,12,187,0.06417112299465241
train,scratches_86.xml,200,200,scratches,104,17,116,198,110.0,107.5,12,181,0.06629834254143646
train,scratches_86.xml,200,200,scratches,138,35,147,198,142.5,116.5,9,163,0.05521472392638037
train,scratches_87.xml,200,200,scratches,150,1,164,193,157.0,97.0,14,192,0.07291666666666667
train,scratches_88.xml,200,200,scratches,103,1,116,186,109.5,93.5,13,185,0.07027027027027027
train,scratches_88.xml,200,200,scratches,172,1,181,193,176.5,97.0,9,192,0.046875
train,scratches_89.xml,200,200,scratches,65,4,76,175,70.5,89.5,11,171,0.06432748538011696
train,scratches_9.xml,200,200,scratches,132,1,180,170,156.0,85.5,48,169,0.28402366863905326
train,scratches_9.xml,200,200,scratches,142,121,164,199,153.0,160.0,22,78,0.28205128205128205
train,scratches_90.xml,200,200,scratches,170,52,191,199,180.5,125.5,21,147,0.14285714285714285
train,scratches_91.xml,200,200,scratches,84,19,107,199,95.5,109.0,23,180,0.12777777777777777
train,scratches_92.xml,200,200,scratches,35,2,52,199,43.5,100.5,17,197,0.08629441624365482
train,scratches_92.xml,200,200,scratches,60,31,90,192,75.0,111.5,30,161,0.18633540372670807
train,scratches_92.xml,200,200,inclusion,173,169,190,200,181.5,184.5,17,31,0.5483870967741935
train,scratches_93.xml,200,200,scratches,28,88,41,197,34.5,142.5,13,109,0.11926605504587157
train,scratches_93.xml,200,200,scratches,61,52,80,196,70.5,124.0,19,144,0.13194444444444445
train,scratches_94.xml,200,200,scratches,93,1,115,199,104.0,100.0,22,198,0.1111111111111111
train,scratches_94.xml,200,200,scratches,22,97,42,199,32.0,148.0,20,102,0.19607843137254902
train,scratches_94.xml,200,200,scratches,120,35,145,173,132.5,104.0,25,138,0.18115942028985507
train,scratches_94.xml,200,200,inclusion,71,95,85,172,78.0,133.5,14,77,0.18181818181818182
train,scratches_95.xml,200,200,scratches,21,36,35,198,28.0,117.0,14,162,0.08641975308641975
train,scratches_96.xml,200,200,scratches,154,1,177,150,165.5,75.5,23,149,0.15436241610738255
train,scratches_97.xml,200,200,scratches,79,49,93,200,86.0,124.5,14,151,0.09271523178807947
train,scratches_97.xml,200,200,scratches,112,9,129,194,120.5,101.5,17,185,0.0918918918918919
train,scratches_97.xml,200,200,inclusion,42,97,56,142,49.0,119.5,14,45,0.3111111111111111
train,scratches_98.xml,200,200,scratches,6,130,199,146,102.5,138.0,193,16,12.0625
train,scratches_99.xml,200,200,scratches,1,136,199,163,100.0,149.5,198,27,7.333333333333333
validation,crazing_241.xml,200,200,crazing,1,9,188,184,94.5,96.5,187,175,1.0685714285714285
validation,crazing_242.xml,200,200,crazing,17,4,196,199,106.5,101.5,179,195,0.9179487179487179
validation,crazing_243.xml,200,200,crazing,1,1,187,198,94.0,99.5,186,197,0.9441624365482234
validation,crazing_244.xml,200,200,crazing,1,6,198,192,99.5,99.0,197,186,1.0591397849462365
validation,crazing_245.xml,200,200,crazing,63,1,200,164,131.5,82.5,137,163,0.8404907975460123
validation,crazing_246.xml,200,200,crazing,1,1,200,173,100.5,87.0,199,172,1.1569767441860466
validation,crazing_247.xml,200,200,crazing,1,1,148,190,74.5,95.5,147,189,0.7777777777777778
validation,crazing_248.xml,200,200,crazing,2,23,200,192,101.0,107.5,198,169,1.1715976331360947
validation,crazing_249.xml,200,200,crazing,1,10,200,191,100.5,100.5,199,181,1.0994475138121547
validation,crazing_250.xml,200,200,crazing,7,2,200,180,103.5,91.0,193,178,1.0842696629213484
validation,crazing_251.xml,200,200,crazing,4,7,200,192,102.0,99.5,196,185,1.0594594594594595
validation,crazing_252.xml,200,200,crazing,1,1,199,157,100.0,79.0,198,156,1.2692307692307692
validation,crazing_253.xml,200,200,crazing,31,2,196,197,113.5,99.5,165,195,0.8461538461538461
validation,crazing_254.xml,200,200,crazing,46,26,183,162,114.5,94.0,137,136,1.0073529411764706
validation,crazing_255.xml,200,200,crazing,4,2,200,166,102.0,84.0,196,164,1.1951219512195121
validation,crazing_256.xml,200,200,crazing,24,1,196,187,110.0,94.0,172,186,0.9247311827956989
validation,crazing_257.xml,200,200,crazing,1,1,186,198,93.5,99.5,185,197,0.9390862944162437
validation,crazing_258.xml,200,200,crazing,50,36,178,199,114.0,117.5,128,163,0.7852760736196319
validation,crazing_259.xml,200,200,crazing,1,1,160,198,80.5,99.5,159,197,0.8071065989847716
validation,crazing_260.xml,200,200,crazing,1,19,198,198,99.5,108.5,197,179,1.100558659217877
validation,crazing_261.xml,200,200,crazing,3,1,199,200,101.0,100.5,196,199,0.9849246231155779
validation,crazing_262.xml,200,200,crazing,1,29,188,197,94.5,113.0,187,168,1.1130952380952381
validation,crazing_263.xml,200,200,crazing,1,16,170,189,85.5,102.5,169,173,0.976878612716763
validation,crazing_264.xml,200,200,crazing,1,23,200,165,100.5,94.0,199,142,1.4014084507042253
validation,crazing_265.xml,200,200,crazing,1,13,198,186,99.5,99.5,197,173,1.138728323699422
validation,crazing_266.xml,200,200,crazing,1,6,193,199,97.0,102.5,192,193,0.9948186528497409
validation,crazing_267.xml,200,200,crazing,1,5,177,182,89.0,93.5,176,177,0.9943502824858758
validation,crazing_268.xml,200,200,crazing,1,10,197,189,99.0,99.5,196,179,1.094972067039106
validation,crazing_269.xml,200,200,crazing,1,14,175,187,88.0,100.5,174,173,1.0057803468208093
validation,crazing_270.xml,200,200,crazing,1,1,198,191,99.5,96.0,197,190,1.0368421052631578
validation,crazing_271.xml,200,200,crazing,2,19,193,186,97.5,102.5,191,167,1.1437125748502994
validation,crazing_272.xml,200,200,crazing,2,1,200,191,101.0,96.0,198,190,1.0421052631578946
validation,crazing_273.xml,200,200,crazing,4,1,196,134,100.0,67.5,192,133,1.443609022556391
validation,crazing_274.xml,200,200,crazing,1,1,194,185,97.5,93.0,193,184,1.048913043478261
validation,crazing_275.xml,200,200,crazing,3,26,200,197,101.5,111.5,197,171,1.152046783625731
validation,crazing_276.xml,200,200,crazing,8,27,172,199,90.0,113.0,164,172,0.9534883720930233
validation,crazing_277.xml,200,200,crazing,2,3,200,187,101.0,95.0,198,184,1.076086956521739
validation,crazing_278.xml,200,200,crazing,1,1,199,179,100.0,90.0,198,178,1.1123595505617978
validation,crazing_279.xml,200,200,crazing,13,24,200,199,106.5,111.5,187,175,1.0685714285714285
validation,crazing_280.xml,200,200,crazing,4,108,106,185,55.0,146.5,102,77,1.3246753246753247
validation,crazing_281.xml,200,200,crazing,10,26,188,185,99.0,105.5,178,159,1.119496855345912
validation,crazing_282.xml,200,200,crazing,1,31,181,195,91.0,113.0,180,164,1.0975609756097562
validation,crazing_283.xml,200,200,crazing,3,2,200,192,101.5,97.0,197,190,1.0368421052631578
validation,crazing_284.xml,200,200,crazing,17,16,184,170,100.5,93.0,167,154,1.0844155844155845
validation,crazing_285.xml,200,200,crazing,1,11,83,65,42.0,38.0,82,54,1.5185185185185186
validation,crazing_285.xml,200,200,crazing,86,18,198,196,142.0,107.0,112,178,0.6292134831460674
validation,crazing_286.xml,200,200,crazing,1,9,195,154,98.0,81.5,194,145,1.3379310344827586
validation,crazing_287.xml,200,200,crazing,1,31,131,191,66.0,111.0,130,160,0.8125
validation,crazing_288.xml,200,200,crazing,1,3,165,188,83.0,95.5,164,185,0.8864864864864865
validation,crazing_289.xml,200,200,crazing,44,26,183,191,113.5,108.5,139,165,0.8424242424242424
validation,crazing_290.xml,200,200,crazing,1,1,189,172,95.0,86.5,188,171,1.0994152046783625
validation,crazing_291.xml,200,200,crazing,1,1,194,151,97.5,76.0,193,150,1.2866666666666666
validation,crazing_292.xml,200,200,crazing,2,1,199,194,100.5,97.5,197,193,1.0207253886010363
validation,crazing_293.xml,200,200,crazing,8,1,196,188,102.0,94.5,188,187,1.0053475935828877
validation,crazing_294.xml,200,200,crazing,1,1,166,200,83.5,100.5,165,199,0.8291457286432161
validation,crazing_295.xml,200,200,crazing,6,4,167,157,86.5,80.5,161,153,1.0522875816993464
validation,crazing_296.xml,200,200,crazing,2,31,176,165,89.0,98.0,174,134,1.2985074626865671
validation,crazing_297.xml,200,200,crazing,1,1,193,169,97.0,85.0,192,168,1.1428571428571428
validation,crazing_298.xml,200,200,crazing,3,35,195,199,99.0,117.0,192,164,1.170731707317073
validation,crazing_299.xml,200,200,crazing,2,1,200,196,101.0,98.5,198,195,1.0153846153846153
validation,crazing_300.xml,200,200,crazing,1,1,192,197,96.5,99.0,191,196,0.9744897959183674
validation,inclusion_241.xml,200,200,inclusion,18,124,36,170,27.0,147.0,18,46,0.391304347826087
validation,inclusion_241.xml,200,200,inclusion,126,76,140,115,133.0,95.5,14,39,0.358974358974359
validation,inclusion_242.xml,200,200,inclusion,97,34,138,158,117.5,96.0,41,124,0.33064516129032256
validation,inclusion_243.xml,200,200,inclusion,10,72,40,149,25.0,110.5,30,77,0.38961038961038963
validation,inclusion_243.xml,200,200,inclusion,56,41,74,88,65.0,64.5,18,47,0.3829787234042553
validation,inclusion_243.xml,200,200,inclusion,134,52,153,114,143.5,83.0,19,62,0.3064516129032258
validation,inclusion_244.xml,200,200,inclusion,44,6,101,199,72.5,102.5,57,193,0.29533678756476683
validation,inclusion_244.xml,200,200,inclusion,175,5,195,52,185.0,28.5,20,47,0.425531914893617
validation,inclusion_245.xml,200,200,inclusion,85,81,137,180,111.0,130.5,52,99,0.5252525252525253
validation,inclusion_246.xml,200,200,inclusion,55,122,79,190,67.0,156.0,24,68,0.35294117647058826
validation,inclusion_246.xml,200,200,inclusion,161,1,193,198,177.0,99.5,32,197,0.16243654822335024
validation,inclusion_247.xml,200,200,inclusion,90,1,125,197,107.5,99.0,35,196,0.17857142857142858
validation,inclusion_248.xml,200,200,inclusion,129,1,157,196,143.0,98.5,28,195,0.14358974358974358
validation,inclusion_249.xml,200,200,inclusion,43,1,75,200,59.0,100.5,32,199,0.16080402010050251
validation,inclusion_250.xml,200,200,inclusion,90,1,125,198,107.5,99.5,35,197,0.17766497461928935
validation,inclusion_251.xml,200,200,inclusion,115,50,133,113,124.0,81.5,18,63,0.2857142857142857
validation,inclusion_252.xml,200,200,inclusion,54,2,78,187,66.0,94.5,24,185,0.12972972972972974
validation,inclusion_252.xml,200,200,inclusion,143,2,166,68,154.5,35.0,23,66,0.3484848484848485
validation,inclusion_253.xml,200,200,inclusion,133,1,155,124,144.0,62.5,22,123,0.17886178861788618
validation,inclusion_254.xml,200,200,inclusion,63,1,88,165,75.5,83.0,25,164,0.1524390243902439
validation,inclusion_254.xml,200,200,inclusion,68,142,101,198,84.5,170.0,33,56,0.5892857142857143
validation,inclusion_255.xml,200,200,inclusion,84,1,121,199,102.5,100.0,37,198,0.18686868686868688
validation,inclusion_256.xml,200,200,inclusion,117,1,157,198,137.0,99.5,40,197,0.20304568527918782
validation,inclusion_257.xml,200,200,inclusion,64,1,95,190,79.5,95.5,31,189,0.164021164021164
validation,inclusion_258.xml,200,200,inclusion,25,6,67,192,46.0,99.0,42,186,0.22580645161290322
validation,inclusion_258.xml,200,200,inclusion,130,1,175,199,152.5,100.0,45,198,0.22727272727272727
validation,inclusion_259.xml,200,200,inclusion,132,29,163,195,147.5,112.0,31,166,0.18674698795180722
validation,inclusion_260.xml,200,200,inclusion,39,24,68,198,53.5,111.0,29,174,0.16666666666666666
validation,inclusion_260.xml,200,200,inclusion,149,58,170,133,159.5,95.5,21,75,0.28
validation,inclusion_261.xml,200,200,inclusion,30,4,62,188,46.0,96.0,32,184,0.17391304347826086
validation,inclusion_261.xml,200,200,inclusion,146,45,167,114,156.5,79.5,21,69,0.30434782608695654
validation,inclusion_262.xml,200,200,inclusion,1,3,56,197,28.5,100.0,55,194,0.28350515463917525
validation,inclusion_262.xml,200,200,inclusion,118,12,151,199,134.5,105.5,33,187,0.17647058823529413
validation,inclusion_263.xml,200,200,inclusion,80,1,106,198,93.0,99.5,26,197,0.1319796954314721
validation,inclusion_264.xml,200,200,inclusion,26,1,68,199,47.0,100.0,42,198,0.21212121212121213
validation,inclusion_264.xml,200,200,inclusion,134,1,176,196,155.0,98.5,42,195,0.2153846153846154
validation,inclusion_265.xml,200,200,inclusion,23,1,45,117,34.0,59.0,22,116,0.1896551724137931
validation,inclusion_265.xml,200,200,inclusion,136,1,176,198,156.0,99.5,40,197,0.20304568527918782
validation,inclusion_266.xml,200,200,inclusion,20,26,68,174,44.0,100.0,48,148,0.32432432432432434
validation,inclusion_266.xml,200,200,inclusion,138,1,179,199,158.5,100.0,41,198,0.20707070707070707
validation,inclusion_267.xml,200,200,inclusion,33,106,56,183,44.5,144.5,23,77,0.2987012987012987
validation,inclusion_267.xml,200,200,inclusion,141,5,183,199,162.0,102.0,42,194,0.21649484536082475
validation,inclusion_268.xml,200,200,inclusion,133,1,171,199,152.0,100.0,38,198,0.1919191919191919
validation,inclusion_269.xml,200,200,inclusion,46,13,73,199,59.5,106.0,27,186,0.14516129032258066
validation,inclusion_269.xml,200,200,inclusion,142,1,179,196,160.5,98.5,37,195,0.18974358974358974
validation,inclusion_270.xml,200,200,inclusion,26,1,64,199,45.0,100.0,38,198,0.1919191919191919
validation,inclusion_271.xml,200,200,inclusion,23,3,56,199,39.5,101.0,33,196,0.1683673469387755
validation,inclusion_271.xml,200,200,inclusion,68,46,90,131,79.0,88.5,22,85,0.25882352941176473
validation,inclusion_271.xml,200,200,inclusion,176,100,199,199,187.5,149.5,23,99,0.23232323232323232
validation,inclusion_272.xml,200,200,inclusion,30,40,58,188,44.0,114.0,28,148,0.1891891891891892
validation,inclusion_272.xml,200,200,inclusion,135,1,157,191,146.0,96.0,22,190,0.11578947368421053
validation,inclusion_273.xml,200,200,inclusion,26,27,48,96,37.0,61.5,22,69,0.3188405797101449
validation,inclusion_273.xml,200,200,inclusion,27,93,46,151,36.5,122.0,19,58,0.3275862068965517
validation,inclusion_274.xml,200,200,inclusion,13,4,44,192,28.5,98.0,31,188,0.16489361702127658
validation,inclusion_274.xml,200,200,inclusion,112,28,142,181,127.0,104.5,30,153,0.19607843137254902
validation,inclusion_274.xml,200,200,inclusion,168,1,180,37,174.0,19.0,12,36,0.3333333333333333
validation,inclusion_275.xml,200,200,inclusion,30,124,46,162,38.0,143.0,16,38,0.42105263157894735
validation,inclusion_275.xml,200,200,inclusion,63,23,86,171,74.5,97.0,23,148,0.1554054054054054
validation,inclusion_275.xml,200,200,inclusion,152,18,177,195,164.5,106.5,25,177,0.14124293785310735
validation,inclusion_276.xml,200,200,inclusion,84,1,134,197,109.0,99.0,50,196,0.25510204081632654
validation,inclusion_277.xml,200,200,inclusion,31,1,65,199,48.0,100.0,34,198,0.1717171717171717
validation,inclusion_278.xml,200,200,inclusion,33,52,59,152,46.0,102.0,26,100,0.26
validation,inclusion_278.xml,200,200,inclusion,136,1,171,199,153.5,100.0,35,198,0.17676767676767677
validation,inclusion_279.xml,200,200,inclusion,67,12,97,184,82.0,98.0,30,172,0.1744186046511628
validation,inclusion_280.xml,200,200,inclusion,42,1,68,197,55.0,99.0,26,196,0.1326530612244898
validation,inclusion_281.xml,200,200,inclusion,130,31,155,174,142.5,102.5,25,143,0.17482517482517482
validation,inclusion_282.xml,200,200,inclusion,91,20,121,114,106.0,67.0,30,94,0.3191489361702128
validation,inclusion_282.xml,200,200,inclusion,91,96,110,181,100.5,138.5,19,85,0.2235294117647059
validation,inclusion_283.xml,200,200,inclusion,33,9,62,190,47.5,99.5,29,181,0.16022099447513813
validation,inclusion_284.xml,200,200,inclusion,25,106,43,135,34.0,120.5,18,29,0.6206896551724138
validation,inclusion_284.xml,200,200,inclusion,166,33,198,107,182.0,70.0,32,74,0.43243243243243246
validation,inclusion_285.xml,200,200,inclusion,61,5,100,196,80.5,100.5,39,191,0.20418848167539266
validation,inclusion_286.xml,200,200,inclusion,40,4,68,200,54.0,102.0,28,196,0.14285714285714285
validation,inclusion_287.xml,200,200,inclusion,2,20,20,107,11.0,63.5,18,87,0.20689655172413793
validation,inclusion_287.xml,200,200,inclusion,3,105,21,146,12.0,125.5,18,41,0.43902439024390244
validation,inclusion_287.xml,200,200,inclusion,21,19,45,138,33.0,78.5,24,119,0.20168067226890757
validation,inclusion_287.xml,200,200,inclusion,27,137,46,190,36.5,163.5,19,53,0.3584905660377358
validation,inclusion_287.xml,200,200,inclusion,91,3,113,137,102.0,70.0,22,134,0.16417910447761194
validation,inclusion_287.xml,200,200,inclusion,145,7,174,182,159.5,94.5,29,175,0.1657142857142857
validation,inclusion_288.xml,200,200,inclusion,26,6,58,199,42.0,102.5,32,193,0.16580310880829016
validation,inclusion_289.xml,200,200,inclusion,40,1,67,200,53.5,100.5,27,199,0.135678391959799
validation,inclusion_290.xml,200,200,inclusion,23,1,57,179,40.0,90.0,34,178,0.19101123595505617
validation,inclusion_291.xml,200,200,inclusion,1,6,31,166,16.0,86.0,30,160,0.1875
validation,inclusion_291.xml,200,200,inclusion,83,4,108,163,95.5,83.5,25,159,0.15723270440251572
validation,inclusion_291.xml,200,200,inclusion,168,2,199,164,183.5,83.0,31,162,0.19135802469135801
validation,inclusion_292.xml,200,200,inclusion,1,46,18,144,9.5,95.0,17,98,0.17346938775510204
validation,inclusion_292.xml,200,200,inclusion,77,27,108,166,92.5,96.5,31,139,0.22302158273381295
validation,inclusion_292.xml,200,200,inclusion,93,164,108,200,100.5,182.0,15,36,0.4166666666666667
validation,inclusion_292.xml,200,200,inclusion,184,80,198,113,191.0,96.5,14,33,0.42424242424242425
validation,inclusion_293.xml,200,200,inclusion,35,1,64,94,49.5,47.5,29,93,0.3118279569892473
validation,inclusion_293.xml,200,200,inclusion,110,67,129,135,119.5,101.0,19,68,0.27941176470588236
validation,inclusion_293.xml,200,200,inclusion,121,97,161,199,141.0,148.0,40,102,0.39215686274509803
validation,inclusion_294.xml,200,200,inclusion,20,23,45,179,32.5,101.0,25,156,0.16025641025641027
validation,inclusion_295.xml,200,200,inclusion,130,14,170,200,150.0,107.0,40,186,0.21505376344086022
validation,inclusion_296.xml,200,200,inclusion,51,1,80,197,65.5,99.0,29,196,0.14795918367346939
validation,inclusion_297.xml,200,200,inclusion,21,2,60,184,40.5,93.0,39,182,0.21428571428571427
validation,inclusion_298.xml,200,200,inclusion,131,56,154,94,142.5,75.0,23,38,0.6052631578947368
validation,inclusion_298.xml,200,200,inclusion,156,24,180,192,168.0,108.0,24,168,0.14285714285714285
validation,inclusion_299.xml,200,200,inclusion,111,68,137,188,124.0,128.0,26,120,0.21666666666666667
validation,inclusion_300.xml,200,200,inclusion,132,50,167,168,149.5,109.0,35,118,0.2966101694915254
validation,patches_241.xml,200,200,patches,71,41,125,177,98.0,109.0,54,136,0.39705882352941174
validation,patches_242.xml,200,200,patches,7,37,85,157,46.0,97.0,78,120,0.65
validation,patches_242.xml,200,200,patches,103,92,165,135,134.0,113.5,62,43,1.441860465116279
validation,patches_242.xml,200,200,patches,147,1,194,55,170.5,28.0,47,54,0.8703703703703703
validation,patches_243.xml,200,200,patches,21,1,96,76,58.5,38.5,75,75,1.0
validation,patches_243.xml,200,200,patches,111,10,182,53,146.5,31.5,71,43,1.6511627906976745
validation,patches_243.xml,200,200,patches,10,149,84,200,47.0,174.5,74,51,1.4509803921568627
validation,patches_243.xml,200,200,patches,139,101,187,158,163.0,129.5,48,57,0.8421052631578947
validation,patches_243.xml,200,200,patches,27,88,72,162,49.5,125.0,45,74,0.6081081081081081
validation,patches_244.xml,200,200,patches,24,50,75,90,49.5,70.0,51,40,1.275
validation,patches_244.xml,200,200,patches,43,106,128,167,85.5,136.5,85,61,1.3934426229508197
validation,patches_245.xml,200,200,patches,5,37,44,71,24.5,54.0,39,34,1.1470588235294117
validation,patches_245.xml,200,200,patches,3,1,60,17,31.5,9.0,57,16,3.5625
validation,patches_245.xml,200,200,patches,1,98,84,195,42.5,146.5,83,97,0.8556701030927835
validation,patches_245.xml,200,200,patches,115,2,178,97,146.5,49.5,63,95,0.6631578947368421
validation,patches_245.xml,200,200,patches,131,122,182,163,156.5,142.5,51,41,1.2439024390243902
validation,patches_245.xml,200,200,patches,144,166,188,199,166.0,182.5,44,33,1.3333333333333333
validation,patches_245.xml,200,200,inclusion,176,3,199,41,187.5,22.0,23,38,0.6052631578947368
validation,patches_246.xml,200,200,patches,145,39,193,82,169.0,60.5,48,43,1.1162790697674418
validation,patches_246.xml,200,200,patches,4,1,60,172,32.0,86.5,56,171,0.32748538011695905
validation,patches_246.xml,200,200,patches,158,95,199,142,178.5,118.5,41,47,0.8723404255319149
validation,patches_246.xml,200,200,patches,100,128,163,170,131.5,149.0,63,42,1.5
validation,patches_246.xml,200,200,patches,30,33,95,98,62.5,65.5,65,65,1.0
validation,patches_247.xml,200,200,patches,8,56,44,199,26.0,127.5,36,143,0.2517482517482518
validation,patches_247.xml,200,200,patches,95,1,171,193,133.0,97.0,76,192,0.3958333333333333
validation,patches_248.xml,200,200,patches,10,1,73,68,41.5,34.5,63,67,0.9402985074626866
validation,patches_248.xml,200,200,patches,17,104,75,200,46.0,152.0,58,96,0.6041666666666666
validation,patches_248.xml,200,200,patches,159,1,198,36,178.5,18.5,39,35,1.1142857142857143
validation,patches_248.xml,200,200,patches,121,26,179,73,150.0,49.5,58,47,1.2340425531914894
validation,patches_248.xml,200,200,patches,141,79,179,121,160.0,100.0,38,42,0.9047619047619048
validation,patches_249.xml,200,200,patches,66,7,158,180,112.0,93.5,92,173,0.5317919075144508
validation,patches_249.xml,200,200,patches,116,25,156,102,136.0,63.5,40,77,0.5194805194805194
validation,patches_249.xml,200,200,inclusion,22,74,50,144,36.0,109.0,28,70,0.4
validation,patches_250.xml,200,200,patches,37,1,80,60,58.5,30.5,43,59,0.7288135593220338
validation,patches_250.xml,200,200,patches,19,103,71,200,45.0,151.5,52,97,0.5360824742268041
validation,patches_250.xml,200,200,patches,107,1,152,52,129.5,26.5,45,51,0.8823529411764706
validation,patches_250.xml,200,200,patches,119,130,156,195,137.5,162.5,37,65,0.5692307692307692
validation,patches_251.xml,200,200,patches,72,1,126,91,99.0,46.0,54,90,0.6
validation,patches_252.xml,200,200,patches,127,106,193,156,160.0,131.0,66,50,1.32
validation,patches_252.xml,200,200,patches,121,163,176,200,148.5,181.5,55,37,1.4864864864864864
validation,patches_252.xml,200,200,patches,19,150,62,197,40.5,173.5,43,47,0.9148936170212766
validation,patches_253.xml,200,200,patches,65,64,130,155,97.5,109.5,65,91,0.7142857142857143
validation,patches_253.xml,200,200,patches,2,29,34,89,18.0,59.0,32,60,0.5333333333333333
validation,patches_253.xml,200,200,patches,128,62,167,118,147.5,90.0,39,56,0.6964285714285714
validation,patches_254.xml,200,200,patches,60,128,109,191,84.5,159.5,49,63,0.7777777777777778
validation,patches_254.xml,200,200,patches,45,27,129,86,87.0,56.5,84,59,1.423728813559322
validation,patches_255.xml,200,200,patches,111,126,184,200,147.5,163.0,73,74,0.9864864864864865
validation,patches_255.xml,200,200,patches,142,10,178,39,160.0,24.5,36,29,1.2413793103448276
validation,patches_255.xml,200,200,patches,1,68,26,109,13.5,88.5,25,41,0.6097560975609756
validation,patches_256.xml,200,200,patches,6,1,88,79,47.0,40.0,82,78,1.0512820512820513
validation,patches_256.xml,200,200,patches,119,54,171,125,145.0,89.5,52,71,0.7323943661971831
validation,patches_257.xml,200,200,patches,10,131,60,175,35.0,153.0,50,44,1.1363636363636365
validation,patches_257.xml,200,200,patches,2,85,65,126,33.5,105.5,63,41,1.5365853658536586
validation,patches_257.xml,200,200,patches,1,13,42,89,21.5,51.0,41,76,0.5394736842105263
validation,patches_257.xml,200,200,patches,134,23,199,134,166.5,78.5,65,111,0.5855855855855856
validation,patches_258.xml,200,200,patches,91,60,154,148,122.5,104.0,63,88,0.7159090909090909
validation,patches_258.xml,200,200,patches,132,144,167,185,149.5,164.5,35,41,0.8536585365853658
validation,patches_258.xml,200,200,patches,22,81,52,116,37.0,98.5,30,35,0.8571428571428571
validation,patches_259.xml,200,200,patches,1,124,62,187,31.5,155.5,61,63,0.9682539682539683
validation,patches_259.xml,200,200,patches,78,8,119,36,98.5,22.0,41,28,1.4642857142857142
validation,patches_259.xml,200,200,patches,7,49,52,152,29.5,100.5,45,103,0.4368932038834951
validation,patches_259.xml,200,200,inclusion,34,47,68,81,51.0,64.0,34,34,1.0
validation,patches_259.xml,200,200,inclusion,171,8,199,26,185.0,17.0,28,18,1.5555555555555556
validation,patches_260.xml,200,200,patches,96,127,180,197,138.0,162.0,84,70,1.2
validation,patches_260.xml,200,200,inclusion,166,78,196,145,181.0,111.5,30,67,0.44776119402985076
validation,patches_261.xml,200,200,patches,15,75,60,141,37.5,108.0,45,66,0.6818181818181818
validation,patches_261.xml,200,200,patches,132,114,191,184,161.5,149.0,59,70,0.8428571428571429
validation,patches_261.xml,200,200,patches,100,122,135,163,117.5,142.5,35,41,0.8536585365853658
validation,patches_261.xml,200,200,patches,162,56,200,105,181.0,80.5,38,49,0.7755102040816326
validation,patches_262.xml,200,200,patches,81,82,149,200,115.0,141.0,68,118,0.576271186440678
validation,patches_262.xml,200,200,patches,1,112,40,187,20.5,149.5,39,75,0.52
validation,patches_262.xml,200,200,patches,14,53,53,101,33.5,77.0,39,48,0.8125
validation,patches_263.xml,200,200,patches,42,59,100,185,71.0,122.0,58,126,0.4603174603174603
validation,patches_263.xml,200,200,patches,58,124,162,200,110.0,162.0,104,76,1.368421052631579
validation,patches_264.xml,200,200,patches,34,52,104,185,69.0,118.5,70,133,0.5263157894736842
validation,patches_264.xml,200,200,patches,119,102,175,199,147.0,150.5,56,97,0.5773195876288659
validation,patches_265.xml,200,200,patches,1,115,62,197,31.5,156.0,61,82,0.7439024390243902
validation,patches_265.xml,200,200,patches,127,6,188,95,157.5,50.5,61,89,0.6853932584269663
validation,patches_265.xml,200,200,patches,18,43,52,82,35.0,62.5,34,39,0.8717948717948718
validation,patches_265.xml,200,200,inclusion,135,167,174,198,154.5,182.5,39,31,1.2580645161290323
validation,patches_266.xml,200,200,patches,74,5,182,103,128.0,54.0,108,98,1.1020408163265305
validation,patches_266.xml,200,200,patches,4,2,38,31,21.0,16.5,34,29,1.1724137931034482
validation,patches_266.xml,200,200,patches,9,6,62,76,35.5,41.0,53,70,0.7571428571428571
validation,patches_267.xml,200,200,patches,11,1,94,121,52.5,61.0,83,120,0.6916666666666667
validation,patches_267.xml,200,200,patches,21,149,78,189,49.5,169.0,57,40,1.425
validation,patches_267.xml,200,200,patches,138,62,194,197,166.0,129.5,56,135,0.4148148148148148
validation,patches_267.xml,200,200,patches,141,1,194,64,167.5,32.5,53,63,0.8412698412698413
validation,patches_268.xml,200,200,patches,14,9,78,199,46.0,104.0,64,190,0.3368421052631579
validation,patches_268.xml,200,200,patches,122,124,180,167,151.0,145.5,58,43,1.3488372093023255
validation,patches_268.xml,200,200,patches,144,16,181,58,162.5,37.0,37,42,0.8809523809523809
validation,patches_269.xml,200,200,patches,2,52,53,151,27.5,101.5,51,99,0.5151515151515151
validation,patches_269.xml,200,200,patches,115,40,159,174,137.0,107.0,44,134,0.3283582089552239
validation,patches_269.xml,200,200,patches,115,169,158,200,136.5,184.5,43,31,1.3870967741935485
validation,patches_270.xml,200,200,patches,88,72,146,171,117.0,121.5,58,99,0.5858585858585859
validation,patches_270.xml,200,200,patches,88,1,145,34,116.5,17.5,57,33,1.7272727272727273
validation,patches_271.xml,200,200,patches,87,53,175,125,131.0,89.0,88,72,1.2222222222222223
validation,patches_271.xml,200,200,patches,129,157,166,200,147.5,178.5,37,43,0.8604651162790697
validation,patches_272.xml,200,200,patches,51,29,109,141,80.0,85.0,58,112,0.5178571428571429
validation,patches_273.xml,200,200,patches,10,117,67,175,38.5,146.0,57,58,0.9827586206896551
validation,patches_273.xml,200,200,patches,13,50,53,95,33.0,72.5,40,45,0.8888888888888888
validation,patches_273.xml,200,200,patches,123,1,187,185,155.0,93.0,64,184,0.34782608695652173
validation,patches_274.xml,200,200,patches,97,139,164,199,130.5,169.0,67,60,1.1166666666666667
validation,patches_275.xml,200,200,patches,31,24,81,143,56.0,83.5,50,119,0.42016806722689076
validation,patches_275.xml,200,200,patches,64,126,108,169,86.0,147.5,44,43,1.0232558139534884
validation,patches_276.xml,200,200,patches,4,101,50,150,27.0,125.5,46,49,0.9387755102040817
validation,patches_276.xml,200,200,patches,34,1,84,71,59.0,36.0,50,70,0.7142857142857143
validation,patches_276.xml,200,200,patches,138,1,194,105,166.0,53.0,56,104,0.5384615384615384
validation,patches_276.xml,200,200,patches,141,68,176,131,158.5,99.5,35,63,0.5555555555555556
validation,patches_277.xml,200,200,patches,13,88,83,194,48.0,141.0,70,106,0.660377358490566
validation,patches_277.xml,200,200,patches,139,110,187,166,163.0,138.0,48,56,0.8571428571428571
validation,patches_277.xml,200,200,patches,131,1,181,53,156.0,27.0,50,52,0.9615384615384616
validation,patches_277.xml,200,200,patches,8,1,27,23,17.5,12.0,19,22,0.8636363636363636
validation,patches_278.xml,200,200,patches,41,1,115,120,78.0,60.5,74,119,0.6218487394957983
validation,patches_278.xml,200,200,patches,39,93,112,199,75.5,146.0,73,106,0.6886792452830188
validation,patches_279.xml,200,200,patches,11,33,72,81,41.5,57.0,61,48,1.2708333333333333
validation,patches_279.xml,200,200,patches,121,32,171,116,146.0,74.0,50,84,0.5952380952380952
validation,patches_279.xml,200,200,patches,154,153,189,199,171.5,176.0,35,46,0.7608695652173914
validation,patches_280.xml,200,200,patches,60,56,125,200,92.5,128.0,65,144,0.4513888888888889
validation,patches_280.xml,200,200,patches,77,4,114,93,95.5,48.5,37,89,0.4157303370786517
validation,patches_281.xml,200,200,patches,21,1,62,43,41.5,22.0,41,42,0.9761904761904762
validation,patches_281.xml,200,200,patches,119,1,172,198,145.5,99.5,53,197,0.26903553299492383
validation,patches_281.xml,200,200,patches,19,107,52,153,35.5,130.0,33,46,0.717391304347826
validation,patches_282.xml,200,200,patches,10,65,72,149,41.0,107.0,62,84,0.7380952380952381
validation,patches_282.xml,200,200,patches,131,70,186,200,158.5,135.0,55,130,0.4230769230769231
validation,patches_282.xml,200,200,patches,128,1,170,73,149.0,37.0,42,72,0.5833333333333334
validation,patches_283.xml,200,200,patches,51,4,104,73,77.5,38.5,53,69,0.7681159420289855
validation,patches_283.xml,200,200,patches,28,127,110,191,69.0,159.0,82,64,1.28125
validation,patches_283.xml,200,200,patches,76,109,126,162,101.0,135.5,50,53,0.9433962264150944
validation,patches_283.xml,200,200,patches,151,136,177,162,164.0,149.0,26,26,1.0
validation,patches_284.xml,200,200,patches,86,1,164,192,125.0,96.5,78,191,0.4083769633507853
validation,patches_284.xml,200,200,patches,46,120,105,179,75.5,149.5,59,59,1.0
validation,patches_285.xml,200,200,patches,64,1,127,135,95.5,68.0,63,134,0.4701492537313433
validation,patches_285.xml,200,200,patches,148,1,200,46,174.0,23.5,52,45,1.1555555555555554
validation,patches_285.xml,200,200,patches,73,126,135,200,104.0,163.0,62,74,0.8378378378378378
validation,patches_286.xml,200,200,patches,65,29,143,199,104.0,114.0,78,170,0.4588235294117647
validation,patches_286.xml,200,200,patches,168,91,200,157,184.0,124.0,32,66,0.48484848484848486
validation,patches_286.xml,200,200,patches,68,1,139,34,103.5,17.5,71,33,2.1515151515151514
validation,patches_286.xml,200,200,patches,1,54,15,89,8.0,71.5,14,35,0.4
validation,patches_287.xml,200,200,patches,77,1,146,199,111.5,100.0,69,198,0.3484848484848485
validation,patches_287.xml,200,200,patches,172,1,200,18,186.0,9.5,28,17,1.6470588235294117
validation,patches_288.xml,200,200,patches,114,17,194,190,154.0,103.5,80,173,0.4624277456647399
validation,patches_288.xml,200,200,patches,26,155,56,183,41.0,169.0,30,28,1.0714285714285714
validation,patches_289.xml,200,200,patches,1,10,39,90,20.0,50.0,38,80,0.475
validation,patches_289.xml,200,200,patches,2,96,37,199,19.5,147.5,35,103,0.33980582524271846
validation,patches_289.xml,200,200,patches,114,101,193,181,153.5,141.0,79,80,0.9875
validation,patches_289.xml,200,200,patches,150,18,179,46,164.5,32.0,29,28,1.0357142857142858
validation,patches_289.xml,200,200,patches,52,68,85,110,68.5,89.0,33,42,0.7857142857142857
validation,patches_290.xml,200,200,patches,10,25,60,107,35.0,66.0,50,82,0.6097560975609756
validation,patches_290.xml,200,200,patches,7,119,63,199,35.0,159.0,56,80,0.7
validation,patches_290.xml,200,200,patches,127,105,186,200,156.5,152.5,59,95,0.6210526315789474
validation,patches_290.xml,200,200,patches,125,1,190,50,157.5,25.5,65,49,1.3265306122448979
validation,patches_290.xml,200,200,patches,132,45,190,115,161.0,80.0,58,70,0.8285714285714286
validation,patches_291.xml,200,200,patches,21,40,68,119,44.5,79.5,47,79,0.5949367088607594
validation,patches_291.xml,200,200,patches,9,122,84,198,46.5,160.0,75,76,0.9868421052631579
validation,patches_291.xml,200,200,patches,125,1,187,195,156.0,98.0,62,194,0.31958762886597936
validation,patches_291.xml,200,200,patches,9,1,49,28,29.0,14.5,40,27,1.4814814814814814
validation,patches_292.xml,200,200,patches,59,49,106,118,82.5,83.5,47,69,0.6811594202898551
validation,patches_292.xml,200,200,patches,52,1,100,22,76.0,11.5,48,21,2.2857142857142856
validation,patches_292.xml,200,200,patches,142,51,194,170,168.0,110.5,52,119,0.4369747899159664
validation,patches_292.xml,200,200,patches,1,8,24,47,12.5,27.5,23,39,0.5897435897435898
validation,patches_292.xml,200,200,patches,66,174,107,200,86.5,187.0,41,26,1.5769230769230769
validation,patches_293.xml,200,200,patches,119,54,187,199,153.0,126.5,68,145,0.4689655172413793
validation,patches_293.xml,200,200,patches,135,10,175,85,155.0,47.5,40,75,0.5333333333333333
validation,patches_294.xml,200,200,patches,3,1,67,191,35.0,96.0,64,190,0.3368421052631579
validation,patches_294.xml,200,200,patches,131,67,196,198,163.5,132.5,65,131,0.4961832061068702
validation,patches_295.xml,200,200,patches,6,1,85,191,45.5,96.0,79,190,0.41578947368421054
validation,patches_295.xml,200,200,patches,144,1,200,124,172.0,62.5,56,123,0.45528455284552843
validation,patches_295.xml,200,200,patches,143,118,183,198,163.0,158.0,40,80,0.5
validation,patches_296.xml,200,200,patches,26,1,92,79,59.0,40.0,66,78,0.8461538461538461
validation,patches_296.xml,200,200,patches,116,1,182,70,149.0,35.5,66,69,0.9565217391304348
validation,patches_296.xml,200,200,patches,114,85,178,192,146.0,138.5,64,107,0.5981308411214953
validation,patches_297.xml,200,200,patches,8,27,90,193,49.0,110.0,82,166,0.4939759036144578
validation,patches_297.xml,200,200,patches,135,79,199,195,167.0,137.0,64,116,0.5517241379310345
validation,patches_297.xml,200,200,patches,142,1,198,74,170.0,37.5,56,73,0.7671232876712328
validation,patches_298.xml,200,200,patches,2,84,51,166,26.5,125.0,49,82,0.5975609756097561
validation,patches_298.xml,200,200,patches,133,45,194,108,163.5,76.5,61,63,0.9682539682539683
validation,patches_298.xml,200,200,patches,164,164,197,194,180.5,179.0,33,30,1.1
validation,patches_298.xml,200,200,patches,41,90,83,143,62.0,116.5,42,53,0.7924528301886793
validation,patches_299.xml,200,200,patches,89,26,170,181,129.5,103.5,81,155,0.5225806451612903
validation,patches_299.xml,200,200,patches,1,1,46,34,23.5,17.5,45,33,1.3636363636363635
validation,patches_299.xml,200,200,patches,1,73,54,200,27.5,136.5,53,127,0.41732283464566927
validation,patches_300.xml,200,200,patches,41,64,98,161,69.5,112.5,57,97,0.5876288659793815
validation,patches_300.xml,200,200,patches,47,15,99,86,73.0,50.5,52,71,0.7323943661971831
validation,pitted_surface_241.xml,200,200,pitted_surface,6,17,166,200,86.0,108.5,160,183,0.8743169398907104
validation,pitted_surface_242.xml,200,200,pitted_surface,1,1,200,188,100.5,94.5,199,187,1.0641711229946524
validation,pitted_surface_243.xml,200,200,pitted_surface,6,1,195,196,100.5,98.5,189,195,0.9692307692307692
validation,pitted_surface_244.xml,200,200,pitted_surface,17,33,168,192,92.5,112.5,151,159,0.949685534591195
validation,pitted_surface_245.xml,200,200,pitted_surface,15,2,198,198,106.5,100.0,183,196,0.9336734693877551
validation,pitted_surface_245.xml,200,200,patches,2,1,41,46,21.5,23.5,39,45,0.8666666666666667
validation,pitted_surface_246.xml,200,200,pitted_surface,4,2,198,198,101.0,100.0,194,196,0.9897959183673469
validation,pitted_surface_247.xml,200,200,pitted_surface,8,6,111,161,59.5,83.5,103,155,0.6645161290322581
validation,pitted_surface_247.xml,200,200,patches,20,171,73,200,46.5,185.5,53,29,1.8275862068965518
validation,pitted_surface_248.xml,200,200,pitted_surface,48,1,200,200,124.0,100.5,152,199,0.7638190954773869
validation,pitted_surface_249.xml,200,200,pitted_surface,1,3,198,198,99.5,100.5,197,195,1.0102564102564102
validation,pitted_surface_250.xml,200,200,pitted_surface,4,9,197,199,100.5,104.0,193,190,1.0157894736842106
validation,pitted_surface_251.xml,200,200,pitted_surface,1,1,162,198,81.5,99.5,161,197,0.817258883248731
validation,pitted_surface_252.xml,200,200,pitted_surface,57,1,198,198,127.5,99.5,141,197,0.7157360406091371
validation,pitted_surface_253.xml,200,200,pitted_surface,63,1,200,198,131.5,99.5,137,197,0.6954314720812182
validation,pitted_surface_254.xml,200,200,pitted_surface,12,2,199,198,105.5,100.0,187,196,0.9540816326530612
validation,pitted_surface_255.xml,200,200,pitted_surface,9,1,198,196,103.5,98.5,189,195,0.9692307692307692
validation,pitted_surface_256.xml,200,200,pitted_surface,2,1,200,198,101.0,99.5,198,197,1.0050761421319796
validation,pitted_surface_257.xml,200,200,pitted_surface,80,3,197,197,138.5,100.0,117,194,0.6030927835051546
validation,pitted_surface_258.xml,200,200,pitted_surface,33,3,197,195,115.0,99.0,164,192,0.8541666666666666
validation,pitted_surface_259.xml,200,200,pitted_surface,4,3,199,197,101.5,100.0,195,194,1.0051546391752577
validation,pitted_surface_260.xml,200,200,pitted_surface,1,1,148,198,74.5,99.5,147,197,0.7461928934010152
validation,pitted_surface_261.xml,200,200,pitted_surface,51,6,197,157,124.0,81.5,146,151,0.9668874172185431
validation,pitted_surface_261.xml,200,200,patches,1,104,59,199,30.0,151.5,58,95,0.6105263157894737
validation,pitted_surface_262.xml,200,200,pitted_surface,13,3,198,172,105.5,87.5,185,169,1.0946745562130178
validation,pitted_surface_263.xml,200,200,pitted_surface,13,7,198,200,105.5,103.5,185,193,0.9585492227979274
validation,pitted_surface_264.xml,200,200,pitted_surface,1,1,196,149,98.5,75.0,195,148,1.3175675675675675
validation,pitted_surface_265.xml,200,200,pitted_surface,2,1,196,184,99.0,92.5,194,183,1.0601092896174864
validation,pitted_surface_266.xml,200,200,pitted_surface,1,1,48,177,24.5,89.0,47,176,0.26704545454545453
validation,pitted_surface_266.xml,200,200,pitted_surface,75,15,196,187,135.5,101.0,121,172,0.7034883720930233
validation,pitted_surface_267.xml,200,200,pitted_surface,4,3,200,185,102.0,94.0,196,182,1.0769230769230769
validation,pitted_surface_268.xml,200,200,pitted_surface,8,2,197,199,102.5,100.5,189,197,0.9593908629441624
validation,pitted_surface_269.xml,200,200,pitted_surface,5,1,197,199,101.0,100.0,192,198,0.9696969696969697
validation,pitted_surface_270.xml,200,200,pitted_surface,53,3,196,197,124.5,100.0,143,194,0.7371134020618557
validation,pitted_surface_271.xml,200,200,pitted_surface,5,1,184,194,94.5,97.5,179,193,0.927461139896373
validation,pitted_surface_272.xml,200,200,pitted_surface,5,1,199,198,102.0,99.5,194,197,0.9847715736040609
validation,pitted_surface_272.xml,200,200,patches,96,1,143,31,119.5,16.0,47,30,1.5666666666666667
validation,pitted_surface_273.xml,200,200,pitted_surface,56,16,199,200,127.5,108.0,143,184,0.7771739130434783
validation,pitted_surface_274.xml,200,200,pitted_surface,10,7,198,198,104.0,102.5,188,191,0.9842931937172775
validation,pitted_surface_275.xml,200,200,pitted_surface,23,1,174,192,98.5,96.5,151,191,0.7905759162303665
validation,pitted_surface_276.xml,200,200,pitted_surface,1,1,120,193,60.5,97.0,119,192,0.6197916666666666
validation,pitted_surface_276.xml,200,200,patches,95,124,171,199,133.0,161.5,76,75,1.0133333333333334
validation,pitted_surface_276.xml,200,200,patches,118,1,183,74,150.5,37.5,65,73,0.8904109589041096
validation,pitted_surface_277.xml,200,200,pitted_surface,22,6,181,194,101.5,100.0,159,188,0.8457446808510638
validation,pitted_surface_277.xml,200,200,patches,2,44,35,69,18.5,56.5,33,25,1.32
validation,pitted_surface_278.xml,200,200,pitted_surface,42,14,189,194,115.5,104.0,147,180,0.8166666666666667
validation,pitted_surface_279.xml,200,200,pitted_surface,64,14,200,193,132.0,103.5,136,179,0.7597765363128491
validation,pitted_surface_279.xml,200,200,inclusion,45,33,67,63,56.0,48.0,22,30,0.7333333333333333
validation,pitted_surface_279.xml,200,200,patches,1,112,27,158,14.0,135.0,26,46,0.5652173913043478
validation,pitted_surface_280.xml,200,200,pitted_surface,8,8,200,198,104.0,103.0,192,190,1.0105263157894737
validation,pitted_surface_281.xml,200,200,pitted_surface,52,5,200,192,126.0,98.5,148,187,0.7914438502673797
validation,pitted_surface_281.xml,200,200,inclusion,10,12,38,198,24.0,105.0,28,186,0.15053763440860216
validation,pitted_surface_282.xml,200,200,pitted_surface,9,11,192,189,100.5,100.0,183,178,1.0280898876404494
validation,pitted_surface_283.xml,200,200,pitted_surface,2,9,185,198,93.5,103.5,183,189,0.9682539682539683
validation,pitted_surface_284.xml,200,200,pitted_surface,2,1,198,198,100.0,99.5,196,197,0.9949238578680203
validation,pitted_surface_285.xml,200,200,pitted_surface,19,21,150,191,84.5,106.0,131,170,0.7705882352941177
validation,pitted_surface_286.xml,200,200,pitted_surface,26,2,198,192,112.0,97.0,172,190,0.9052631578947369
validation,pitted_surface_287.xml,200,200,pitted_surface,12,1,199,191,105.5,96.0,187,190,0.9842105263157894
validation,pitted_surface_288.xml,200,200,pitted_surface,22,1,199,141,110.5,71.0,177,140,1.2642857142857142
validation,pitted_surface_289.xml,200,200,pitted_surface,2,18,198,200,100.0,109.0,196,182,1.0769230769230769
validation,pitted_surface_290.xml,200,200,pitted_surface,1,1,198,200,99.5,100.5,197,199,0.9899497487437185
validation,pitted_surface_291.xml,200,200,pitted_surface,1,1,179,195,90.0,98.0,178,194,0.9175257731958762
validation,pitted_surface_291.xml,200,200,patches,170,1,198,66,184.0,33.5,28,65,0.4307692307692308
validation,pitted_surface_292.xml,200,200,pitted_surface,46,1,200,191,123.0,96.0,154,190,0.8105263157894737
validation,pitted_surface_292.xml,200,200,patches,26,136,71,198,48.5,167.0,45,62,0.7258064516129032
validation,pitted_surface_292.xml,200,200,patches,1,43,52,126,26.5,84.5,51,83,0.6144578313253012
validation,pitted_surface_293.xml,200,200,pitted_surface,17,1,199,192,108.0,96.5,182,191,0.9528795811518325
validation,pitted_surface_294.xml,200,200,pitted_surface,1,90,64,199,32.5,144.5,63,109,0.5779816513761468
validation,pitted_surface_294.xml,200,200,pitted_surface,66,66,197,192,131.5,129.0,131,126,1.0396825396825398
validation,pitted_surface_294.xml,200,200,patches,51,38,78,74,64.5,56.0,27,36,0.75
validation,pitted_surface_295.xml,200,200,pitted_surface,52,6,200,156,126.0,81.0,148,150,0.9866666666666667
validation,pitted_surface_295.xml,200,200,patches,9,67,55,131,32.0,99.0,46,64,0.71875
validation,pitted_surface_296.xml,200,200,pitted_surface,3,1,199,198,101.0,99.5,196,197,0.9949238578680203
validation,pitted_surface_296.xml,200,200,patches,92,104,141,177,116.5,140.5,49,73,0.6712328767123288
validation,pitted_surface_297.xml,200,200,pitted_surface,1,4,139,198,70.0,101.0,138,194,0.711340206185567
validation,pitted_surface_298.xml,200,200,pitted_surface,46,1,163,182,104.5,91.5,117,181,0.6464088397790055
validation,pitted_surface_298.xml,200,200,pitted_surface,166,12,197,142,181.5,77.0,31,130,0.23846153846153847
validation,pitted_surface_299.xml,200,200,pitted_surface,2,12,112,178,57.0,95.0,110,166,0.6626506024096386
validation,pitted_surface_299.xml,200,200,pitted_surface,116,21,199,200,157.5,110.5,83,179,0.46368715083798884
validation,pitted_surface_300.xml,200,200,pitted_surface,1,1,198,200,99.5,100.5,197,199,0.9899497487437185
validation,rolled-in_scale_241.xml,200,200,rolled-in_scale,53,3,156,196,104.5,99.5,103,193,0.533678756476684
validation,rolled-in_scale_242.xml,200,200,rolled-in_scale,16,11,132,197,74.0,104.0,116,186,0.6236559139784946
validation,rolled-in_scale_243.xml,200,200,rolled-in_scale,58,26,129,192,93.5,109.0,71,166,0.42771084337349397
validation,rolled-in_scale_244.xml,200,200,rolled-in_scale,25,30,83,136,54.0,83.0,58,106,0.5471698113207547
validation,rolled-in_scale_244.xml,200,200,rolled-in_scale,99,2,178,198,138.5,100.0,79,196,0.4030612244897959
validation,rolled-in_scale_245.xml,200,200,rolled-in_scale,6,31,152,199,79.0,115.0,146,168,0.8690476190476191
validation,rolled-in_scale_246.xml,200,200,rolled-in_scale,2,3,136,180,69.0,91.5,134,177,0.7570621468926554
validation,rolled-in_scale_247.xml,200,200,rolled-in_scale,10,25,89,183,49.5,104.0,79,158,0.5
validation,rolled-in_scale_248.xml,200,200,rolled-in_scale,44,2,161,198,102.5,100.0,117,196,0.5969387755102041
validation,rolled-in_scale_249.xml,200,200,rolled-in_scale,22,62,157,192,89.5,127.0,135,130,1.0384615384615385
validation,rolled-in_scale_250.xml,200,200,rolled-in_scale,91,2,141,198,116.0,100.0,50,196,0.25510204081632654
validation,rolled-in_scale_250.xml,200,200,rolled-in_scale,152,39,199,200,175.5,119.5,47,161,0.2919254658385093
validation,rolled-in_scale_251.xml,200,200,rolled-in_scale,1,1,58,200,29.5,100.5,57,199,0.2864321608040201
validation,rolled-in_scale_252.xml,200,200,rolled-in_scale,49,2,155,199,102.0,100.5,106,197,0.5380710659898477
validation,rolled-in_scale_253.xml,200,200,rolled-in_scale,1,6,122,125,61.5,65.5,121,119,1.0168067226890756
validation,rolled-in_scale_254.xml,200,200,rolled-in_scale,55,110,146,198,100.5,154.0,91,88,1.0340909090909092
validation,rolled-in_scale_255.xml,200,200,rolled-in_scale,1,5,69,197,35.0,101.0,68,192,0.3541666666666667
validation,rolled-in_scale_255.xml,200,200,rolled-in_scale,72,27,113,129,92.5,78.0,41,102,0.4019607843137255
validation,rolled-in_scale_255.xml,200,200,rolled-in_scale,153,50,195,83,174.0,66.5,42,33,1.2727272727272727
validation,rolled-in_scale_256.xml,200,200,rolled-in_scale,19,45,111,199,65.0,122.0,92,154,0.5974025974025974
validation,rolled-in_scale_257.xml,200,200,rolled-in_scale,1,37,68,200,34.5,118.5,67,163,0.4110429447852761
validation,rolled-in_scale_257.xml,200,200,rolled-in_scale,100,31,166,198,133.0,114.5,66,167,0.39520958083832336
validation,rolled-in_scale_258.xml,200,200,rolled-in_scale,8,59,143,200,75.5,129.5,135,141,0.9574468085106383
validation,rolled-in_scale_259.xml,200,200,rolled-in_scale,3,1,200,199,101.5,100.0,197,198,0.9949494949494949
validation,rolled-in_scale_260.xml,200,200,rolled-in_scale,1,1,187,197,94.0,99.0,186,196,0.9489795918367347
validation,rolled-in_scale_261.xml,200,200,rolled-in_scale,6,7,107,131,56.5,69.0,101,124,0.8145161290322581
validation,rolled-in_scale_262.xml,200,200,rolled-in_scale,12,45,121,180,66.5,112.5,109,135,0.8074074074074075
validation,rolled-in_scale_263.xml,200,200,rolled-in_scale,35,2,181,196,108.0,99.0,146,194,0.7525773195876289
validation,rolled-in_scale_264.xml,200,200,rolled-in_scale,32,3,197,189,114.5,96.0,165,186,0.8870967741935484
validation,rolled-in_scale_265.xml,200,200,rolled-in_scale,1,33,54,184,27.5,108.5,53,151,0.3509933774834437
validation,rolled-in_scale_265.xml,200,200,rolled-in_scale,134,91,194,166,164.0,128.5,60,75,0.8
validation,rolled-in_scale_266.xml,200,200,rolled-in_scale,1,22,80,151,40.5,86.5,79,129,0.6124031007751938
validation,rolled-in_scale_266.xml,200,200,rolled-in_scale,121,41,195,93,158.0,67.0,74,52,1.4230769230769231
validation,rolled-in_scale_267.xml,200,200,rolled-in_scale,75,1,197,193,136.0,97.0,122,192,0.6354166666666666
validation,rolled-in_scale_268.xml,200,200,rolled-in_scale,15,27,191,194,103.0,110.5,176,167,1.0538922155688624
validation,rolled-in_scale_269.xml,200,200,rolled-in_scale,112,59,191,118,151.5,88.5,79,59,1.3389830508474576
validation,rolled-in_scale_270.xml,200,200,rolled-in_scale,18,5,122,197,70.0,101.0,104,192,0.5416666666666666
validation,rolled-in_scale_271.xml,200,200,rolled-in_scale,33,1,127,172,80.0,86.5,94,171,0.5497076023391813
validation,rolled-in_scale_272.xml,200,200,rolled-in_scale,41,1,160,199,100.5,100.0,119,198,0.601010101010101
validation,rolled-in_scale_273.xml,200,200,rolled-in_scale,10,1,105,187,57.5,94.0,95,186,0.510752688172043
validation,rolled-in_scale_274.xml,200,200,rolled-in_scale,1,2,123,163,62.0,82.5,122,161,0.7577639751552795
validation,rolled-in_scale_274.xml,200,200,rolled-in_scale,152,129,198,198,175.0,163.5,46,69,0.6666666666666666
validation,rolled-in_scale_275.xml,200,200,rolled-in_scale,43,6,116,199,79.5,102.5,73,193,0.37823834196891193
validation,rolled-in_scale_275.xml,200,200,rolled-in_scale,144,116,199,192,171.5,154.0,55,76,0.7236842105263158
validation,rolled-in_scale_276.xml,200,200,rolled-in_scale,1,32,49,76,25.0,54.0,48,44,1.0909090909090908
validation,rolled-in_scale_276.xml,200,200,rolled-in_scale,78,1,133,47,105.5,24.0,55,46,1.1956521739130435
validation,rolled-in_scale_277.xml,200,200,rolled-in_scale,1,130,67,196,34.0,163.0,66,66,1.0
validation,rolled-in_scale_277.xml,200,200,rolled-in_scale,107,25,149,71,128.0,48.0,42,46,0.9130434782608695
validation,rolled-in_scale_277.xml,200,200,rolled-in_scale,150,26,200,128,175.0,77.0,50,102,0.49019607843137253
validation,rolled-in_scale_278.xml,200,200,rolled-in_scale,1,36,54,179,27.5,107.5,53,143,0.3706293706293706
validation,rolled-in_scale_278.xml,200,200,rolled-in_scale,57,45,196,197,126.5,121.0,139,152,0.9144736842105263
validation,rolled-in_scale_279.xml,200,200,rolled-in_scale,33,60,115,195,74.0,127.5,82,135,0.6074074074074074
validation,rolled-in_scale_279.xml,200,200,rolled-in_scale,120,38,189,150,154.5,94.0,69,112,0.6160714285714286
validation,rolled-in_scale_280.xml,200,200,rolled-in_scale,65,28,162,198,113.5,113.0,97,170,0.5705882352941176
validation,rolled-in_scale_281.xml,200,200,rolled-in_scale,96,1,166,200,131.0,100.5,70,199,0.35175879396984927
validation,rolled-in_scale_282.xml,200,200,rolled-in_scale,31,1,161,200,96.0,100.5,130,199,0.6532663316582915
validation,rolled-in_scale_283.xml,200,200,rolled-in_scale,30,3,176,197,103.0,100.0,146,194,0.7525773195876289
validation,rolled-in_scale_284.xml,200,200,rolled-in_scale,55,98,131,199,93.0,148.5,76,101,0.7524752475247525
validation,rolled-in_scale_285.xml,200,200,rolled-in_scale,35,1,171,191,103.0,96.0,136,190,0.7157894736842105
validation,rolled-in_scale_286.xml,200,200,rolled-in_scale,30,15,152,171,91.0,93.0,122,156,0.782051282051282
validation,rolled-in_scale_287.xml,200,200,rolled-in_scale,3,1,101,199,52.0,100.0,98,198,0.494949494949495
validation,rolled-in_scale_288.xml,200,200,rolled-in_scale,45,6,162,198,103.5,102.0,117,192,0.609375
validation,rolled-in_scale_289.xml,200,200,rolled-in_scale,68,1,195,178,131.5,89.5,127,177,0.7175141242937854
validation,rolled-in_scale_290.xml,200,200,rolled-in_scale,1,1,126,198,63.5,99.5,125,197,0.6345177664974619
validation,rolled-in_scale_291.xml,200,200,rolled-in_scale,80,1,199,197,139.5,99.0,119,196,0.6071428571428571
validation,rolled-in_scale_292.xml,200,200,rolled-in_scale,24,1,162,200,93.0,100.5,138,199,0.6934673366834171
validation,rolled-in_scale_293.xml,200,200,rolled-in_scale,39,3,167,191,103.0,97.0,128,188,0.6808510638297872
validation,rolled-in_scale_294.xml,200,200,rolled-in_scale,29,21,112,179,70.5,100.0,83,158,0.5253164556962026
validation,rolled-in_scale_294.xml,200,200,rolled-in_scale,116,98,163,199,139.5,148.5,47,101,0.46534653465346537
validation,rolled-in_scale_295.xml,200,200,rolled-in_scale,52,1,167,198,109.5,99.5,115,197,0.583756345177665
validation,rolled-in_scale_296.xml,200,200,rolled-in_scale,2,36,112,191,57.0,113.5,110,155,0.7096774193548387
validation,rolled-in_scale_297.xml,200,200,rolled-in_scale,54,45,168,197,111.0,121.0,114,152,0.75
validation,rolled-in_scale_298.xml,200,200,rolled-in_scale,73,147,141,199,107.0,173.0,68,52,1.3076923076923077
validation,rolled-in_scale_299.xml,200,200,rolled-in_scale,41,1,153,198,97.0,99.5,112,197,0.5685279187817259
validation,rolled-in_scale_300.xml,200,200,rolled-in_scale,53,11,125,200,89.0,105.5,72,189,0.38095238095238093
validation,scratches_241.xml,200,200,scratches,1,25,199,50,100.0,37.5,198,25,7.92
validation,scratches_241.xml,200,200,scratches,1,106,161,136,81.0,121.0,160,30,5.333333333333333
validation,scratches_242.xml,200,200,scratches,7,35,108,52,57.5,43.5,101,17,5.9411764705882355
validation,scratches_242.xml,200,200,scratches,82,156,199,171,140.5,163.5,117,15,7.8
validation,scratches_242.xml,200,200,inclusion,2,169,27,195,14.5,182.0,25,26,0.9615384615384616
validation,scratches_243.xml,200,200,scratches,49,12,200,39,124.5,25.5,151,27,5.592592592592593
validation,scratches_243.xml,200,200,scratches,24,147,179,165,101.5,156.0,155,18,8.61111111111111
validation,scratches_243.xml,200,200,scratches,123,45,198,59,160.5,52.0,75,14,5.357142857142857
validation,scratches_244.xml,200,200,scratches,2,42,199,61,100.5,51.5,197,19,10.368421052631579
validation,scratches_244.xml,200,200,scratches,84,88,196,111,140.0,99.5,112,23,4.869565217391305
validation,scratches_245.xml,200,200,scratches,1,70,99,81,50.0,75.5,98,11,8.909090909090908
validation,scratches_245.xml,200,200,scratches,3,18,198,31,100.5,24.5,195,13,15.0
validation,scratches_246.xml,200,200,scratches,2,157,180,171,91.0,164.0,178,14,12.714285714285714
validation,scratches_247.xml,200,200,scratches,117,37,133,169,125.0,103.0,16,132,0.12121212121212122
validation,scratches_248.xml,200,200,scratches,36,176,146,195,91.0,185.5,110,19,5.7894736842105265
validation,scratches_248.xml,200,200,scratches,75,21,197,36,136.0,28.5,122,15,8.133333333333333
validation,scratches_249.xml,200,200,scratches,27,92,199,112,113.0,102.0,172,20,8.6
validation,scratches_250.xml,200,200,scratches,2,82,199,107,100.5,94.5,197,25,7.88
validation,scratches_250.xml,200,200,scratches,33,175,180,197,106.5,186.0,147,22,6.681818181818182
validation,scratches_251.xml,200,200,scratches,1,155,192,188,96.5,171.5,191,33,5.787878787878788
validation,scratches_251.xml,200,200,scratches,74,128,190,151,132.0,139.5,116,23,5.043478260869565
validation,scratches_252.xml,200,200,scratches,1,78,199,111,100.0,94.5,198,33,6.0
validation,scratches_253.xml,200,200,scratches,1,135,199,167,100.0,151.0,198,32,6.1875
validation,scratches_254.xml,200,200,scratches,4,131,199,153,101.5,142.0,195,22,8.863636363636363
validation,scratches_255.xml,200,200,scratches,1,138,199,166,100.0,152.0,198,28,7.071428571428571
validation,scratches_256.xml,200,200,scratches,1,90,199,124,100.0,107.0,198,34,5.823529411764706
validation,scratches_257.xml,200,200,scratches,1,45,200,77,100.5,61.0,199,32,6.21875
validation,scratches_258.xml,200,200,scratches,1,128,200,161,100.5,144.5,199,33,6.03030303030303
validation,scratches_259.xml,200,200,scratches,1,85,200,121,100.5,103.0,199,36,5.527777777777778
validation,scratches_260.xml,200,200,scratches,1,24,200,50,100.5,37.0,199,26,7.653846153846154
validation,scratches_260.xml,200,200,scratches,96,73,199,85,147.5,79.0,103,12,8.583333333333334
validation,scratches_261.xml,200,200,scratches,1,151,199,180,100.0,165.5,198,29,6.827586206896552
validation,scratches_262.xml,200,200,scratches,1,111,195,139,98.0,125.0,194,28,6.928571428571429
validation,scratches_263.xml,200,200,scratches,1,25,198,50,99.5,37.5,197,25,7.88
validation,scratches_264.xml,200,200,scratches,34,71,200,104,117.0,87.5,166,33,5.03030303030303
validation,scratches_264.xml,200,200,scratches,1,116,198,147,99.5,131.5,197,31,6.354838709677419
validation,scratches_265.xml,200,200,scratches,1,166,181,194,91.0,180.0,180,28,6.428571428571429
validation,scratches_265.xml,200,200,scratches,2,120,200,151,101.0,135.5,198,31,6.387096774193548
validation,scratches_266.xml,200,200,scratches,1,181,87,193,44.0,187.0,86,12,7.166666666666667
validation,scratches_266.xml,200,200,scratches,1,139,198,159,99.5,149.0,197,20,9.85
validation,scratches_267.xml,200,200,scratches,1,141,119,160,60.0,150.5,118,19,6.2105263157894735
validation,scratches_267.xml,200,200,scratches,113,181,198,196,155.5,188.5,85,15,5.666666666666667
validation,scratches_268.xml,200,200,scratches,1,122,93,133,47.0,127.5,92,11,8.363636363636363
validation,scratches_268.xml,200,200,scratches,1,149,197,165,99.0,157.0,196,16,12.25
validation,scratches_269.xml,200,200,scratches,1,54,152,71,76.5,62.5,151,17,8.882352941176471
validation,scratches_269.xml,200,200,scratches,112,95,197,107,154.5,101.0,85,12,7.083333333333333
validation,scratches_269.xml,200,200,scratches,1,118,198,142,99.5,130.0,197,24,8.208333333333334
validation,scratches_270.xml,200,200,scratches,1,59,198,77,99.5,68.0,197,18,10.944444444444445
validation,scratches_270.xml,200,200,scratches,1,116,198,142,99.5,129.0,197,26,7.576923076923077
validation,scratches_271.xml,200,200,scratches,1,44,198,65,99.5,54.5,197,21,9.380952380952381
validation,scratches_271.xml,200,200,scratches,88,114,200,128,144.0,121.0,112,14,8.0
validation,scratches_271.xml,200,200,scratches,1,82,111,94,56.0,88.0,110,12,9.166666666666666
validation,scratches_271.xml,200,200,scratches,1,87,198,116,99.5,101.5,197,29,6.793103448275862
validation,scratches_272.xml,200,200,scratches,64,41,199,68,131.5,54.5,135,27,5.0
validation,scratches_272.xml,200,200,scratches,24,82,199,115,111.5,98.5,175,33,5.303030303030303
validation,scratches_273.xml,200,200,scratches,1,18,199,62,100.0,40.0,198,44,4.5
validation,scratches_273.xml,200,200,scratches,44,134,199,166,121.5,150.0,155,32,4.84375
validation,scratches_273.xml,200,200,scratches,1,182,199,198,100.0,190.0,198,16,12.375
validation,scratches_274.xml,200,200,scratches,1,38,199,68,100.0,53.0,198,30,6.6
validation,scratches_274.xml,200,200,scratches,1,133,198,163,99.5,148.0,197,30,6.566666666666666
validation,scratches_274.xml,200,200,scratches,1,187,199,198,100.0,192.5,198,11,18.0
validation,scratches_275.xml,200,200,scratches,1,16,150,33,75.5,24.5,149,17,8.764705882352942
validation,scratches_275.xml,200,200,scratches,123,57,199,69,161.0,63.0,76,12,6.333333333333333
validation,scratches_275.xml,200,200,scratches,1,86,200,101,100.5,93.5,199,15,13.266666666666667
validation,scratches_275.xml,200,200,scratches,1,166,199,198,100.0,182.0,198,32,6.1875
validation,scratches_276.xml,200,200,scratches,1,56,94,70,47.5,63.0,93,14,6.642857142857143
validation,scratches_276.xml,200,200,scratches,1,136,199,164,100.0,150.0,198,28,7.071428571428571
validation,scratches_277.xml,200,200,scratches,1,21,200,49,100.5,35.0,199,28,7.107142857142857
validation,scratches_278.xml,200,200,scratches,1,7,199,37,100.0,22.0,198,30,6.6
validation,scratches_278.xml,200,200,scratches,1,158,62,176,31.5,167.0,61,18,3.388888888888889
validation,scratches_278.xml,200,200,scratches,1,60,170,75,85.5,67.5,169,15,11.266666666666667
validation,scratches_279.xml,200,200,scratches,1,49,199,75,100.0,62.0,198,26,7.615384615384615
validation,scratches_279.xml,200,200,scratches,1,98,199,116,100.0,107.0,198,18,11.0
validation,scratches_280.xml,200,200,scratches,1,33,198,65,99.5,49.0,197,32,6.15625
validation,scratches_280.xml,200,200,scratches,1,83,199,99,100.0,91.0,198,16,12.375
validation,scratches_281.xml,200,200,scratches,40,16,199,41,119.5,28.5,159,25,6.36
validation,scratches_282.xml,200,200,scratches,4,154,199,176,101.5,165.0,195,22,8.863636363636363
validation,scratches_283.xml,200,200,scratches,1,130,171,153,86.0,141.5,170,23,7.391304347826087
validation,scratches_283.xml,200,200,scratches,12,11,188,37,100.0,24.0,176,26,6.769230769230769
validation,scratches_284.xml,200,200,scratches,1,100,123,124,62.0,112.0,122,24,5.083333333333333
validation,scratches_284.xml,200,200,scratches,151,108,199,124,175.0,116.0,48,16,3.0
validation,scratches_285.xml,200,200,scratches,1,47,141,68,71.0,57.5,140,21,6.666666666666667
validation,scratches_285.xml,200,200,scratches,140,50,199,70,169.5,60.0,59,20,2.95
validation,scratches_286.xml,200,200,scratches,1,104,150,121,75.5,112.5,149,17,8.764705882352942
validation,scratches_287.xml,200,200,scratches,156,1,187,199,171.5,100.0,31,198,0.15656565656565657
validation,scratches_288.xml,200,200,scratches,62,1,87,197,74.5,99.0,25,196,0.12755102040816327
validation,scratches_289.xml,200,200,scratches,114,2,132,198,123.0,100.0,18,196,0.09183673469387756
validation,scratches_290.xml,200,200,scratches,10,28,159,43,84.5,35.5,149,15,9.933333333333334
validation,scratches_290.xml,200,200,scratches,24,62,192,79,108.0,70.5,168,17,9.882352941176471
validation,scratches_290.xml,200,200,inclusion,1,157,57,177,29.0,167.0,56,20,2.8
validation,scratches_291.xml,200,200,scratches,1,127,196,150,98.5,138.5,195,23,8.478260869565217
validation,scratches_292.xml,200,200,scratches,1,101,200,152,100.5,126.5,199,51,3.9019607843137254
validation,scratches_292.xml,200,200,scratches,1,163,194,177,97.5,170.0,193,14,13.785714285714286
validation,scratches_293.xml,200,200,scratches,77,173,194,189,135.5,181.0,117,16,7.3125
validation,scratches_293.xml,200,200,scratches,20,87,104,114,62.0,100.5,84,27,3.111111111111111
validation,scratches_294.xml,200,200,scratches,1,7,199,69,100.0,38.0,198,62,3.193548387096774
validation,scratches_294.xml,200,200,scratches,2,80,128,120,65.0,100.0,126,40,3.15
validation,scratches_294.xml,200,200,scratches,1,108,194,123,97.5,115.5,193,15,12.866666666666667
validation,scratches_295.xml,200,200,scratches,1,10,199,49,100.0,29.5,198,39,5.076923076923077
validation,scratches_295.xml,200,200,scratches,45,55,108,84,76.5,69.5,63,29,2.1724137931034484
validation,scratches_295.xml,200,200,scratches,63,98,197,136,130.0,117.0,134,38,3.526315789473684
validation,scratches_295.xml,200,200,scratches,1,121,59,138,30.0,129.5,58,17,3.411764705882353
validation,scratches_296.xml,200,200,scratches,25,96,139,128,82.0,112.0,114,32,3.5625
validation,scratches_296.xml,200,200,scratches,112,141,200,156,156.0,148.5,88,15,5.866666666666666
validation,scratches_296.xml,200,200,scratches,1,141,76,153,38.5,147.0,75,12,6.25
validation,scratches_296.xml,200,200,scratches,150,26,200,51,175.0,38.5,50,25,2.0
validation,scratches_297.xml,200,200,scratches,132,122,199,138,165.5,130.0,67,16,4.1875
validation,scratches_297.xml,200,200,scratches,13,121,99,135,56.0,128.0,86,14,6.142857142857143
validation,scratches_298.xml,200,200,scratches,6,7,199,44,102.5,25.5,193,37,5.216216216216216
validation,scratches_299.xml,200,200,scratches,2,135,200,186,101.0,160.5,198,51,3.8823529411764706
validation,scratches_300.xml,200,200,scratches,88,1,200,34,144.0,17.5,112,33,3.393939393939394
validation,scratches_300.xml,200,200,scratches,2,16,86,34,44.0,25.0,84,18,4.666666666666667
